%%%%%%%%%%%%%%%%%%%%%
%         %       % %
% %%%%% % %%% %%% % %
% %   % %     %   % %
% %%% % %%%%%%% %%% %
%   % % %   %     % %
%%% % % % % %%%%% % %
%   % %   %   % %   %
%P%%% %%%%% % % %%% %
%     %   % % %     %
%%%%%%% % % % %%%%%%%
%     % % % %       %
% %%%%% % %.%%%%% % %
%     % % %     % % %
%%%%% % % % %%% %%% %
% %   % %   % %     %
% % %%% %%%%% %%%%% %
%   %     %   %   % %
% %%%%%%% % % % % % %
%         % %   %   %
%%%%%%%%%%%%%%%%%%%%%
