%%%%%%%%%%%%%%%%%%%%%
%         % %       %
% %%%%%P% % % % %%%%%
% %     % %   %     %
% % %%% % %%%%%%%%% %
% %   %           % %
% %%%%%%%%%%%%%%% % %
%     %   % %     % %
%%%%% %%% % % %%%%% %
%   %     % %       %
%%% %%%%%%% %%%%%%% %
%     %         %   %
% %%%%% % %%%%% % %%%
%       %     % % % %
% %%%%%%%%%%%.%%% % %
%       %   %   %   %
%%%%%%% % % %%% %%% %
% %     % % % %   % %
% % %%%%% % % % %%% %
%         %   %     %
%%%%%%%%%%%%%%%%%%%%%
