%%%%%%%%%%%%%%%%%%%%%
%         %       % %
% %%%%% % % % %%% % %
% % %   % % % %     %
% P % %%%%% % %%%%% %
% % %   %   % %   % %
% % %%% % %%% % % %%%
% %   % % %   % %   %
% %%% % % % %%% %%% %
%   % % % %     %   %
%%% % % % %%%%% % %%%
%   % %   %   . %   %
% %%% %%%%% % % %%% %
%   %   %   % %   % %
%%% %%% % %%% %%%%% %
% %   % % %       % %
% %%% % % %%%%%%% % %
%   % % % %   %     %
% %%% % % % % %%%%% %
%       %   %   %   %
%%%%%%%%%%%%%%%%%%%%%
