%%%%%%%%%%%%%%%%%%%%%
%   % %           % %
% % % % %%%%%%%%% % %
% % % % %     % %   %
% % % % % %%% % %%% %
% %   %   %   %   % %
% %%% %%%%% %%% % % %
%   % %   % % % %   %
% % % % % %%% % %%%%%
% %P% % %     %     %
% % % % %%% %%%%%%% %
% % % %   %         %
% % %%%%% %%%%%%%%%%%
% %     %     %     %
% %%%%% %%%%% % %%%%%
%   %     %   %     %
%%% % % %%% %.%%%%% %
%   % % %   %     % %
% %%% %%% %%% %%% % %
%   %         %     %
%%%%%%%%%%%%%%%%%%%%%
