%%%%%%%%%%%%%%%%%%%%%
%   %     %         %
% %%% %%% % %%%%%%% %
%     %   %     %   %
% %%%%% %%%%% %%% % %
% %   % %     %   % %
% %%% % %%%%%%% %%%%%
%     %       %     %
%%%%% %%%%%%%%%%%%% %
%P  % %   %         %
% %%% % % % %%%%%%% %
%   % % %   %     % %
%%% % % %%%%% % %%% %
%   % %   %   %   % %
% %%% % % % %%%%% % %
%     % % % %   % % %
% %%%%% % . % % % % %
%     % % % % %   % %
%%%%% %%% % % %%%%% %
%         % %       %
%%%%%%%%%%%%%%%%%%%%%
