%%%%%%%%%%%%%%%%%%%%%
%   %   % %   %     %
%%% % % % % % %%%%% %
%   % %   % %       %
% %%% %%%%% %%%%%%% %
%   %       %   % % %
%%% %%%%%%%%% % % % %
%             %   % %
% P%%%%%%%% %%%%%%% %
%         % %   %   %
% %%%%%%% %.% % % %%%
% %     %     % % % %
% % %%% %%%%%%% % % %
% %   %     % %   % %
% %%% % %%% % %%%%% %
% %   %   % %       %
% %%%%%%% % % %%%%% %
%   %     % % %     %
%%% % %%%%% % % %%%%%
%     %       %     %
%%%%%%%%%%%%%%%%%%%%%
