%%%%%
%   %
%%% %
%   %
% %%%
%   %
% % %
% % %
% % %
%P% %
% % %
% % %
% % %
% % %
% % %
% % %
%%% %
%   %
% % %
% % %
%%% %
% % %
% % %
%   %
% .%%
%   %
%%% %
%   %
% %%%
%   %
%%%%%
