%%%%%%%%%%%%%%%%%%%%%
%           %       %
%%% %%%%%%% %%% %%%%%
%   %     %     %   %
% %%% % %%%%%%% % % %
% %   %         % % %
% %%%%% %P%%%%%%% % %
%     %     % %   % %
% %%% %%%%% % % %%% %
% % %   % % %   %   %
% % %%% % % %%%%% %%%
%   %   %       %   %
% %%% %%% %%%%%%%%% %
% %   % % % .       %
%%% %%% % % %%%%%%%%%
%   %     %   %     %
% % %%%%%%%%% %%% % %
% % %       %   % % %
% %%% %%%%% %%% %%% %
%         %         %
%%%%%%%%%%%%%%%%%%%%%
