##P##################
#   #     #   #     #
# # # ### # # ##### #
# # # # # # #     # #
# ### # # # ##### # #
# #   # # #     # # #
# # ### # ####### # #
# # #   #       # # #
# # # # ####### # # #
# # # # #   #   # # #
# # # ### # # # # # #
#   # #   # # # #   #
# ### # ### # ##### #
# #   # #   #       #
# ### # # ###########
#   #   #           #
### ########### .## #
# # #   #     # #   #
# # # # # ### # # ###
#     #   #     #   #
#####################
