%%%%%
%P  %
% % %
% % %
%%% %
%   %
%%% %
% % %
% % %
%   %
% %%%
%   %
%%% %
%   %
% %%%
% . %
%%% %
%   %
% %%%
%   %
%%% %
% % %
% % %
%   %
% %%%
% % %
% % %
%   %
%%% %
%   %
%%%%%
