%%%%%%%%%%%%%%%%%%%%%
%     P         %   %
%%%%%%%%% %%% % % % %
%   %   %   % % % % %
% % % % %%% % %%% % %
% % % %   % %     % %
% % % %%% %%%%%%%%% %
% % %   %     %     %
% % %%% %%%%% % %%% %
% %     % %     %   %
% %%%%%%% . %%%%%%%%%
% %   %   % %   %   %
% % % % % % % % % % %
% % % % %   % % % % %
% % % % %%%%% % %%% %
%   % %     % %     %
% %%% %%%%%%% %%%%%%%
% % %   %   % %     %
% % %%% % % % %%% % %
%     %   %       % %
%%%%%%%%%%%%%%%%%%%%%
