%%%%%%%%%%%%%%%%%%%%%
%             %     %
% %%%%%%%%%%%%% %%% %
%             % %   %
%%%%%%%%%%%%% % % % %
%       %     % % % %
% %%%%% % %%% % % %%%
% %       %   % %   %
% % %%%%%%%%% % %%% %
% % %  P%   % % % % %
% %%% % % % %%% % % %
% %   %   %     . % %
% % %%%%%%%%%%%%% % %
%   %           % % %
%%%%% %%%%%%%%% % % %
%     %   %   % % % %
% %%%%% % % % % % % %
% %     %   % % % % %
% %%%%%%%%% % % %%% %
%         % %       %
%%%%%%%%%%%%%%%%%%%%%
