%%%%%%%%%%%%%%%%%%%%%
%     %   %         %
% % % % % %%%%%%%%% %
% % %   %           %
% % %%%%% %%%%%%%%% %
% % %     %   %     %
%P% %%%%%%% % % %%%%%
% %         % % %   %
% %%%%%%%%%%% % % % %
% %         % %   % %
% % % %%%%%%% .%%%%%%
% % % %       %     %
% % % % %%%%%%% %%% %
% % % % %   %   % % %
% % %%% %%% % %%% % %
% %   %   % %   %   %
% % % %%% % %%% % %%%
% % %   % %     % % %
% %%% % % %%%%%%% % %
%     % %           %
%%%%%%%%%%%%%%%%%%%%%
