%%%%%
%   %
% %%%
%P  %
%%% %
%   %
% % %
% % %
% % %
% % %
% %%%
%   %
%%% %
%   %
% % %
% % %
% % %
% % %
% % %
% % %
% %%%
%   %
%%% %
%   %
%%% %
% . %
% %%%
%   %
%%% %
%   %
%%%%%
