%%%%%
%   %
%%% %
%   %
% %%%
%   %
%%% %
%   %
% %%%
% % %
% % %
% % %
%P% %
%   %
% %%%
% % %
% % %
% % %
% % %
% % %
% % %
% % %
% % %
%   %
%%% %
% % %
% . %
%   %
% %%%
%   %
%%%%%
