%%%%%
%   %
% %%%
%   %
% % %
% % %
%%% %
%P. %
% %%%
%   %
% % %
% % %
%%% %
%   %
% % %
% % %
% % %
% % %
% % %
% % %
%%% %
%   %
% %%%
%   %
%%% %
%   %
% %%%
% % %
% % %
%   %
%%%%%
