%%%%%
%   %
%P%%%
%   %
% . %
% % %
%%% %
%   %
% %%%
% % %
% % %
% % %
% % %
%   %
% %%%
% % %
% % %
%   %
%%% %
%   %
% %%%
% % %
% % %
% % %
% % %
%   %
%%% %
% % %
% % %
%   %
%%%%%
