%%%%%
%   %
% % %
% % %
% % %
% % %
% %%%
% % %
%P% %
% % %
% % %
%   %
% %%%
%   %
%%% %
% % %
% . %
% % %
% % %
%   %
% %%%
% % %
% % %
% % %
% % %
% % %
% % %
% % %
% % %
%   %
%%%%%
