%%%%%
%   %
% % %
%P% %
% % %
% % %
%%% %
%   %
% % %
% . %
% %%%
%   %
%%% %
%   %
% % %
% % %
% %%%
%   %
%%% %
%   %
% % %
% % %
% %%%
%   %
% % %
% % %
% % %
% % %
% % %
% % %
%%%%%
