%%%%%%%%%%%%%%%%%%%%%%%%%%%%%%%
%  P                          %
%                             %
%                             %
%                             %
%                             %
%                             %
%                             %
%                             %
%                             %
%                             %
%                             %
%                             %
%                             %
%                             %
%                             %
%                             %
%                             %
%                             %
%                             %
%                             %
%                             %
%                             %
%                             %
%                             %
%                             %
%                             %
%                             %
%                    .        %
%                             %
%%%%%%%%%%%%%%%%%%%%%%%%%%%%%%%
