%%%%%%%%%%%%%%%%%%%%%%%%%%%%%%%
%                             %
%                             %
%                             %
%                             %
%                             %
%                             %
%                             %
%                             %
%      P                      %
%                             %
%                             %
%                             %
%                             %
%                             %
%                             %
%                             %
%                             %
%                             %
%                             %
%                     .       %
%                             %
%                             %
%                             %
%                             %
%                             %
%                             %
%                             %
%                             %
%                             %
%%%%%%%%%%%%%%%%%%%%%%%%%%%%%%%
