%%%%%%%%%%%%%%%%%%%%%%%%%%%%%%%
%                             %
%                             %
%                             %
%                             %
%                             %
%                             %
%                             %
%                             %
%                             %
%                             %
%                             %
%                             %
%       P                     %
%                             %
%                             %
%                             %
%                             %
%                             %
%                             %
%                             %
%                             %
%                             %
%                             %
%                             %
%                             %
%                             %
%                             %
%                         .   %
%                             %
%%%%%%%%%%%%%%%%%%%%%%%%%%%%%%%
