%%%%%%%%%%%%%%%%%%%%%%%%%%%%%%%
%                             %
%   P                         %
%                             %
%                             %
%                             %
%                             %
%                             %
%                             %
%                             %
%                             %
%                             %
%                             %
%                             %
%                             %
%                             %
%                             %
%                             %
%                             %
%                             %
%                             %
%                             %
%                             %
%                             %
%                             %
%                 .           %
%                             %
%                             %
%                             %
%                             %
%%%%%%%%%%%%%%%%%%%%%%%%%%%%%%%
