%%%%%%%%%%%%%%%%%%%%%%%%%%%%%%%
%  P                          %
%                             %
%                             %
%                             %
%                             %
%                             %
%                             %
%                             %
%                             %
%                             %
%                             %
%                             %
%                             %
%                             %
%                             %
%                             %
%                             %
%                             %
%                             %
%                             %
%                             %
%               .             %
%                             %
%                             %
%                             %
%                             %
%                             %
%                             %
%                             %
%%%%%%%%%%%%%%%%%%%%%%%%%%%%%%%
