%%%%%%%%%%%%%%%%%%%%%%%%%%%%%%%
%  P                          %
%                             %
%                             %
%                             %
%                             %
%                             %
%                             %
%                             %
%                             %
%                             %
%                             %
%                             %
%                             %
%                             %
%                             %
%                             %
%                             %
%                             %
%                             %
%                             %
%                             %
%                             %
%                             %
%                             %
%                             %
%                             %
%                             %
%                   .         %
%                             %
%%%%%%%%%%%%%%%%%%%%%%%%%%%%%%%
