%%%%%%%%%%%%%%%%%%%%%%%%%%%%%%%
% P                           %
%                             %
%                             %
%                             %
%                             %
%                             %
%                             %
%                             %
%                             %
%                             %
%                             %
%                             %
%                             %
%                             %
%                             %
%                             %
%                             %
%                             %
%                             %
%                             %
%                             %
%                             %
%                             %
%                             %
%                             %
%                             %
%                             %
%                        .    %
%                             %
%%%%%%%%%%%%%%%%%%%%%%%%%%%%%%%
