%%%%%%%%%%%%%%%%%%%%%%%%%%%%%%%
%                             %
%                             %
%            P                %
%                             %
%                             %
%                             %
%                             %
%                             %
%                             %
%                             %
%                             %
%                             %
%                             %
%                             %
%                             %
%                             %
%                             %
%                             %
%                             %
%                             %
%                             %
%                             %
%                             %
%                             %
%                             %
%                             %
%                     .       %
%                             %
%                             %
%%%%%%%%%%%%%%%%%%%%%%%%%%%%%%%
