%%%%%%%%%%%%%%%%%%%%%%%%%%%%%%%
%                             %
%                             %
%                             %
%                             %
%                             %
%                             %
%                             %
%                             %
%                             %
%                             %
%                             %
%                             %
%          P                  %
%                             %
%                             %
%                             %
%                             %
%                             %
%                             %
%                             %
%                             %
%                             %
%                             %
%                             %
%                .            %
%                             %
%                             %
%                             %
%                             %
%%%%%%%%%%%%%%%%%%%%%%%%%%%%%%%
