%%%%%%%%%%%%%%%%%%%%%%%%%%%%%%%
%                             %
%                             %
%                             %
%    P                        %
%                             %
%                             %
%                             %
%                             %
%                             %
%                             %
%                             %
%                             %
%                             %
%                             %
%                             %
%               .             %
%                             %
%                             %
%                             %
%                             %
%                             %
%                             %
%                             %
%                             %
%                             %
%                             %
%                             %
%                             %
%                             %
%%%%%%%%%%%%%%%%%%%%%%%%%%%%%%%
