%%%%%%%%%%%%%%%%%%%%%%%%%%%%%%%
%                             %
%                             %
%                             %
%                             %
%                             %
%                             %
%                             %
%                             %
%                             %
%                             %
%                             %
%                             %
%          P                  %
%                             %
%                             %
%                             %
%                             %
%                             %
%                             %
%                             %
%                             %
%                             %
%                             %
%                             %
%                             %
%                             %
%              .              %
%                             %
%                             %
%%%%%%%%%%%%%%%%%%%%%%%%%%%%%%%
