%%%%
% P%
%  %
%  %
%  %
%  %
%  %
%. %
%%%%