%%%%%%%%%%%%%%%%%%%%%%%%%%%%%%%
%  %                 %     % P%
%  %  %%%%%%%%%%  %%%%%%%  %  %
%  %        %     %           %
%  %%%%  %%%%  %  %%%%%%%%%%  %
%  %  %  %  %  %  %     %   . %
%  %  %  %  %  %  %  %  %  %%%%
%     %     %  %     %  %     %
%  %  %  %%%%%%%  %%%%  %%%%  %
%  %        %     %           %
%  %  %  %  %%%%  %%%%%%%  %%%%
%  %  %  %  %  %  %        %  %
%  %%%%%%%%%%  %%%%  %  %  %  %
%  %           %  %  %  %     %
%%%%  %%%%%%%  %  %%%%%%%  %%%%
%  %  %  %  %  %  %  %        %
%  %  %  %  %%%%  %  %%%%  %%%%
%        %     %        %     %
%  %%%%  %%%%  %%%%%%%  %  %%%%
%  %                          %
%%%%%%%%%%%%%%%%%%%%%%%%%%%%%%%