%%%%%%%%%%%%%%%%%%%%%%%%%%%%%%%
%   %   %         %         % %
% % % % %%% %%%%%%% % %%%%% % %
% %   %   % %       %     %   %
% %%%%%%%%% % %%%%%%%%%%% %%% %
% %P    %     %     %   %   % %
% % %%%%% %%%%% %%% %%% %%% % %
% %     % %     % % %   % % % %
% % %%% % % %%%%% % % % % % % %
% %   % % % %     % % % % % % %
% %%% % % % % % %%% % % % % % %
% %   % % % % %       %   % % %
% % %%% % % % %%%%%%%%%%%%% % %
% %   %   % % %     %     % % %
% %%% %%%%% % %%% %%% %%% % % %
%   %   %   % %   %   % % % % %
%%% %%% % %%% % %%% %%% % % %%%
%   %   %   %   %   % %   %   %
% %%% %%%%% % %%% %%% % %%%%% %
% %         % %   % %   %     %
% %%%%%%% %%%%% %%% % %%% % % %
%   %     %     %   % %   % % %
%%% %%%%%%% %%%%% % % %%%%% % %
% %     %   % %   % %   %.  % %
% %%%%% % %%% % %%% %%% % %%%%%
%     %   %   % % %     %     %
% % %%%%%%% % % % %%%%%%%%%%% %
% %     %   % %         %   % %
% %%%%% % %%% %%%%%%%%% % % % %
%     %     %             %   %
%%%%%%%%%%%%%%%%%%%%%%%%%%%%%%%
