%%%%%%%%%%%%%%%%%%%%%
%P   %       %      %
% % % %%% % %%% %%%%%
% %     % %   %     %
%%%%%%%%% %%% % %%% %
%   %     % % % %   %
% % % %%%%% % % % % %
% %   %     % % % % %
%%%%%%% %%%%% % % %%%
%   %         % %   %
% % % %%%%%%%%% %%% %
% % %   %     % % % %
% % %%% %%% %%% % % %
% %   %   %   %   % %
% % % %%% % % .%% % %
% % %   % % % %   % %
% % %%% % %%% % %%% %
% %   % %   %     % %
% %%% %%%%% %%%%%%% %
%   %               %
%%%%%%%%%%%%%%%%%%%%%
