%%%%%%%%%%%%%%%%%%%%%%%%%%%%%%%
%       %         %     %     %
% %%%%% % % %%%%% %%% % % %%%%%
%   %   % %   % % %   % % %   %
%%% % %%%%%%% % % % %%% % % % %
%   %         % %   % % %   % %
% %%%%%%%%%%%%% %%%%% % % %%% %
%   %                 % %   % %
%%% %%%%%%%%%%% %%%%% % %%%%% %
%   %       %   % %   %     % %
% %%% %%%%% % %%% % %%%%%%% % %
% %   %     % %   % %     %   %
% % %%% %%%%% % %%% %%% %%%%% %
%   %P  %     % %   %   %   % %
% %%% %%% %%%%% % %%% % % % % %
% %   %       %     % % % %   %
%%% % %%%%% % %%%%% % % % %%%%%
%   % %   % % %   %   % % %   %
% %%%%% % % % % % % %%%%% % % %
% %     % % %   % % %     % % %
% % %%%%% % %%%%% % % %%%%% %%%
% %   %   %     % % % %   %   %
% %%% % %%%%%%%%% %%% % % %%% %
%     % %       %   %   %     %
% %%%%% % %%%%% %%% %%%%%%%%% %
%   % % %   % %   %       %   %
%%% % % %%% % %%% %%%%% %%% %%%
% %   %   % % %   %   % %   % %
% %%% % %%% % % %%% .%% % %%% %
%     %       %     %         %
%%%%%%%%%%%%%%%%%%%%%%%%%%%%%%%
