#####################
# #       #         #
# # # ### ### ##### #
# # #   # #   #     #
# # ### # # ### #####
# # #   #   #   #   #
# # # ######### # # #
#   #         # # # #
# ########### # # # #
#   #       # # # # #
### ### ### # # # # #
#   #   #   # #   # #
# ### ####### #######
#     #   #   #     #
### ### # # ### ### #
#   #   #   #   #   #
# ### ### ### ### # #
#   #   # #     # # #
### ### ### P#### # #
#     #     #     # #
#.###################
