%%%%%%%%%%%%%%%%%%%%%%%%%%%%%%%%%%%%%
%                            %     P%
%               %   %               %
%                   %               %
%                   %     %         %
%                   %               %
%                   %               %
%      %            %      %        %
%                          %        %
%                   %  %   %        %
%            %      %      %        %
%   %      %        %      %        %
%                   %      %        %
%      %         %  %      %        %
%%% %%%%%%% %%%%%%%%%      %%%%%%%%%%
%            %                      %
%            %                      %
%            %                      %
%                                   %
%                                   %
%                                   %
%.                                  %
%%%%%%%%%%%%%%%%%%%%%%%%%%%%%%%%%%%%%