%%%%%%%%%%%%%%%%%%%%%%%%%%%%%%%                             
%                            P%
%  %  %%%%  %  %  %  %%%%  %  %
%  %  %     %           %  %  %
%  %%%%%%%  %  %              %
%  %  %     %  %  %        %  %
%%%%  %%%%  %  %%%%  %  %  %  %
%     %        %     %  %     %
%         % % % %%%%%%%%% %  %% 
%               %  %  % % % % %     
%%%%  %%%%  %  %  %  %%%%  %  %
%%        %        %  %       %
% %  %%%      %     %      %  %
%     %                 %     %
%  %%%%  %%%%%%%%%%  %  %%%%  %
%     %        %     %     %  %
%  %%%%%%%  %%%%%%%%%%%%%  %%%%
%     %              %  %     %
%  %  %  %%%%  %%%%  %  %%%%%%%
%. %     %        %           %
%%%%%%%%%%%%%%%%%%%%%%%%%%%%%%%