%%%%%%%%%%%%%%%%%%%%
%              %   %
% %% %% %% %% %% % %
%        P       % %
%%%%%%%%%%%%%%%%%% %
%.                 %
%%%%%%%%%%%%%%%%%%%%
