%%%%%%%%%%%%%%%%%%%%%%%%%%%%%%%
%       %         %         % %
%%% %%% % %%% %%%%% %%% %%% % %
%   %   % % %         % %   % %
% %%% %%% % %%%%%%%%%%% % %%% %
% %   %   %   %   %     %   % %
% % %%% %%% %%% % % %%%%%%% % %
% %   %   %     % %     % % % %
% %%%%%%% %%%%%%% %%%%% % % % %
% %       %         % % %     %
% % %%%%%%% %%%%%%% % % %%%%% %
% %   %   %   %   %   %   % % %
% %%% % % % % %%% %%% %%% % % %
% %   % % % %   %     %   %   %
% % %%% P %%%%% % %%%%% %%%%%%%
% % %   %       % %   %       %
% % % %%%%%%%%%%% % %%%%%%%%% %
%   %   %       % %     %     %
% %%%%% % %%%%%%% %%% % % %%% %
% %     % %     %   % . %   % %
% % %%%%% % %%% %%% % % %%% %%%
%   % %     % %     % % %   % %
%%%%% % %%%%% %%%%%%%%% % %%% %
%     % %           %   %     %
%%%%% % %%%%% %%%%% % %%%%%%%%%
%     %       %   % %         %
% %%%%%%%%%%%%% %%% %%%%% %%% %
%   %     %     %   %   % % % %
% % % %%% % %%% % %%% % % % % %
% %     %     %       %   %   %
%%%%%%%%%%%%%%%%%%%%%%%%%%%%%%%
