%%%%%%%%%%%%%%%%%%%%%%%%%%%%%%%
% %                       %   %
% % % %%%%% %%%%%%%%%%%%%%% % %
% % % %   % % %       %     % %
% % % %%% % % % %%%%% % %%%%% %
%   %   % % %   %   %   %   % %
% %%%%% % % %%%%%%% %%%%% %%% %
% %   % %       %       %   % %
% % % % %%%%%%% % %%%%% % % % %
%   % %       % %     % % %   %
%%%%% %%%%%%% % %%%%% % % %%%%%
%     % %   % P     % % % %   %
% %%%%% % % % %%%%% % %%% % %%%
%     %   % %   % % % %   %   %
%%%%% %%%%% %%% % % % % %%%%% %
% %   %       % %   % %       %
% % %%% %%% %%% % %%% %%%%%%% %
%   %     % %   %         %   %
% %%% %%% %%% %%%%%%% %%%%% %%%
%   % % %   %     %   %     % %
%%% % % %%% %%%%% % %%% %%%%% %
% % %   %       % % %   % %   %
% % %%%%% %%%%%%% %%% %%% % % %
% %     % %     %   % %  .  % %
% %%%%% % % %%% %%% % % %%%%% %
% %     %     %   % % %     % %
% % %%%%%%%%%%%%% % % %%% %%% %
% % %         %   % %   % %   %
% % %%% %%%%% % % % %%% %%% % %
%       %       % %         % %
%%%%%%%%%%%%%%%%%%%%%%%%%%%%%%%
