%%%%%%%%%%%%%%%%%%%%%%%%%%%%%%%
% %         %         %       %
% % %%%%% % % %%% %%%%% %%%%% %
%   %   % % % % % %     %     %
% %%% % %%% % % % % %%%%% %%% %
% %   %   %   % %   %   %   % %
% %%%%%%% % %%% %%%%%%% %%% %%%
%   %     % %             %   %
%%%%% %%%%% % %%% %%%%%%% %%% %
%   %   %   % %   %     % % % %
% % %%% % %%%%% %%% % %%% % % %
% %     %P      %   %       % %
% %%%%%%%%%%%%%%% %%%%%%%%%%% %
% %   %     %   % %   %       %
% % % %%% % % % % % % % % %%%%%
%   %     % % % % % % % % %   %
%%%%%%%%%%% % %%% %%% % %%% % %
%         % %       % %     % %
% %%%%% %%% %%%%%%% % %%%%%%% %
% %   %   % %     %   %     % %
% % % %%% % % %%% %%%%% %%% % %
% % %     %   % %   %   % %   %
% % % %%%%%%%%% .%% % %%% %%% %
% % % %     %     %   % %     %
%%% % % % %%% %%% %%%%% % %%%%%
%   % % %   % %         % %   %
% %%%%% %%% % % %%%%%%%%% %%% %
%     %   % % % %   %   % %   %
% %%% %%% % % % % % % % % % % %
%   %     %   %   %   %     % %
%%%%%%%%%%%%%%%%%%%%%%%%%%%%%%%
