%%%%%%%%%%%%%%%%%%%%%%%%%%%%%%%
%     %     P       %   %     %
% %%%%% %%%%% %%%%% % % %%% %%%
% %   %   % %   %   % %   %   %
% %%% %%% % %%% % %%% %%% %%% %
%   %   %     % % %   %       %
%%% % %%%%%%% % % % %%%%%%%%% %
% % %         % % %       %   %
% % %%%%%%% %%% % %%%%%%% % %%%
% %       % %   %       % % % %
% %%%%%%% % % %%%%%%%%% % % % %
%     %   % %         %   % % %
% %%% % %%%%%%%%% %%% %%%%% % %
% %   %   %     %   % %   % % %
% %%%%%%% % %%% %%% % % % % % %
%         %   % %   % % % % % %
% %%%%%%%%%%% % %%%%% % %%%.% %
%   %         % %   % %     % %
%%% %%% %%%%%%% % % % % %%%%% %
% %     %     % % %   % %     %
% %%%%%%% %%% % % %%%%% % %%% %
%       % %   % % %   % % %   %
% % %%% % %%%%% % %%% % % % %%%
% %   %   %   % %   %     %   %
%%%%% %%%%% % % % % %%%%%%%%% %
%     %     % % % %   %     % %
% %%% % %%%%% % %%%%% % % %%% %
% %   % %   %   %     % %     %
% %%%%% %%% %%%%% %%%%% %%%%%%%
%                 %           %
%%%%%%%%%%%%%%%%%%%%%%%%%%%%%%%
