%%%%%%%%%%%%%%%%%%%%%%%%%%%%%%%
%                 %   %     % %
%%%%%%% %%% %%%%% % % % %%% % %
%       %   %   %   % %   %   %
% %%%%%%%%%%% % %%%%% %%% %%% %
% %   %     % %     % %   %   %
% % % %%%%P % %%%%% % % %%%%%%%
%   %   %   % %   % %   %     %
% %%%%% % %%% % % % %%%%% %%% %
% %   % %   % % % %       % % %
% % % % %%% % % %%%%%%%%%%% % %
%   % %   %   %           % % %
%%%%% %%% %%%%%%% %%%%%%% % % %
%   %   %         % %       % %
% % %%% %%%%%%% %%% % %%%%%%% %
% %   % %     % %   %   %     %
% % %%% %%% % % % % % %%% %%%%%
% %     %   % % % %   %   %   %
% %%%%%%% %%% % %%%%%%% %%%%% %
% %   %   %   %       %     % %
% % % % %%% %%%%%%%.% %%%%% % %
%   %   % %     % %   % %   % %
%%%%%%%%% %%%%% % % % % % %%% %
%     %     % % % % %   % %   %
% %%% % % % % % % % %%% % %%% %
% % %   % %   %   % % % %     %
% % %%%%% %%%%%%% % % % %%%%% %
%       %         % %   %     %
%%%%%%% %%%%%%%%%%% %%%%% %%%%%
%                 %           %
%%%%%%%%%%%%%%%%%%%%%%%%%%%%%%%
