%%%%%%%%%%%%%%%%%%%%%%%%%%%%%%%
%         %             %   % %
%%%%%P%%% % % %%%%%%%%% % % % %
%     % %   % %       %   %   %
% %%%%% %%%%% % %%%%% %%%%%%% %
% % %   %     %     % % %     %
% % % % % %%%%% %%%%% % % %%%%%
% %   %   %     %     %   %   %
% %%%%%%%%% %%%%% %%%%% %%% %%%
%     %     %   %     %   %   %
% %%% % %%%%% % %%%%% %%% %%% %
%   % % % %   % %   %   %     %
%%%%% % % %%%%% % % %%% %%%%% %
%   % % %     %   % %   %     %
% % % % % %%% %%%%% % %%% %%%%%
% %   %   %   %   %   %.  %   %
% % %%%%%%% %%% % %%%%% %%% %%%
% % %       %   %     % %     %
% %%% %%%%%%%%%%% %%%%% % %%% %
%     %           %     %   % %
%%%%%%% % %%%%%%% % %%%%%%% % %
%       %   %     %   %     % %
% %%%%%%%%% %%% %%%%% % %%%%% %
%       % %   %     % % %   % %
%%%%%%% % %%% %%%%% % % % % % %
%   %   %   %     % % %   % % %
% % % %%%%% %%%%% %%% %%%%%%% %
% % %           %   % %       %
% % %%%%%%%%%%% %%% % % %%%%% %
% %               %     %     %
%%%%%%%%%%%%%%%%%%%%%%%%%%%%%%%
