%%%%%%%%%%%%%%%%%%%%%%%%%%%%%%%
% %   %         %     %     % %
% % % % %%% %%% % %%%%% % % % %
%   % % %   % % % %     % %   %
% %%% % % %%% % % % %%%%% %%%%%
%   % % %   %     % %   %     %
%%%%% % %%% %P%%% % % % %%%%% %
%     %   %   %   % % %       %
% %%% %%% %%% %%%%% % % %%%%%%%
% %   %   % %     % % % %     %
% % %%% %%% %%%%% % % % % %%%%%
% % %   %       %   % % % %   %
% % % %%% %%%%% %%%%% % % % % %
% % %     %   % %   % % % % % %
% %%%%%%%%% % % % %%% %%% % % %
% %     %   %   %   %     % % %
% % %%% % %%%%%%%%. %%%%%%% %%%
% % % %   %             % %   %
% % % %%%%% %%%%%%%%%%% % % % %
% %       %           % %   % %
% %%%%%%% %%%%% %%%%% % %%%%% %
%   %   %     % %     % %     %
% %%% % %%%%% % % %%%%% % %%% %
% %   %       % % %   % % %   %
% % %%%%%%%%%%% % % %%% % %%%%%
% %   %   %     % %     %     %
% %%% % % %%%%%%% % %%%%%%% % %
%   %   %     %   % %     % % %
% %%%%%%%%%%% % %%% % %%% %%% %
%               %     %       %
%%%%%%%%%%%%%%%%%%%%%%%%%%%%%%%
