%%%%%%%%%%%%%%%%%%%%%%%%%%%%%%%
%     %           %           %
% % %%% %%% %%%%%%% %%%%% %%% %
% %     % %   %     %   %   % %
% %%%%%%% %%% % %%%%%%% %%% % %
%       %   %   %       %   % %
%%%%%%% %%% %%%%% %%%%%%% %%% %
%     %   %   %   %     % % % %
% %%%%%%% % % %%% % %%% % % % %
%           %     %   %   % % %
% %%%%%%%%%%%%%%% %%% %%%%% % %
% % %     %   %     % % %     %
% % % %%% %%% % %%%%% % % %%%%%
%   % %     %     %   % % %   %
% %%%P%%%%% %%%%%%% %%% % % %%%
% %   %   %         %   % %   %
% % %%% % %%%%%%%%%%% % % %%% %
% %     % %         % %   %   %
% %%%%%%% %%%%% %%% % %%%%% %%%
%       %     %   % % % %     %
% %%%%%%%%% % %%% %%% % % %%% %
% %       % %   %   % % % %   %
% %%%%%%% %%%%% % % % % % % %%%
% %   %   %     % . % %   %   %
% % %%% %%% %%%%% % % % %%%%% %
% % %   %       % %   % %   % %
% % % %%%%%%%%% % %%%%%%% % % %
% % %   %     % % %       %   %
% % %%% % %%% % % %%% %%%%%%% %
%     %   %     %     %       %
%%%%%%%%%%%%%%%%%%%%%%%%%%%%%%%
