%%%%%%%%%%%%%%%%%%%%%%%%%%%%%%%
%       % %     %     %     % %
% %%%%% % % P % % %%%%% % % % %
%   %   % % % %   %     % % % %
%%% % %%% % % %%%%% %%%%% % % %
%   % %   % %   %   %     %   %
% %%% %%% % %%% % %%% %%%%%%% %
%   %     % % %   %   %   %   %
% % %%%%% % % %%%%% %%% %%% %%%
% % %     %   % %   %   %   % %
% % % %%%%%%% % % %%% %%% %%% %
% % % %   %     %   %   %     %
% % %%% % % %%%%%%% % % %%%%% %
% % %   %   %       % %     % %
% % % %%%%%%% % %%%%%%%%%%% % %
% %     %     % %     %     % %
%%%%%%% % %%%%% % %%% % %%%%% %
%     % % %     % %   %       %
% %%% %%% % %%%%% % %%%%%%%%%%%
%   % %   %     % %           %
% % % % %%% %%%%% %%%%%%%%%%% %
% % %   %   %     %   %     % %
%%% %%%%%%%%% %%%%% % %%% % % %
%   %   %   % %   % %   % % % %
% % % % % %%% % % % %%% % %%% %
% % % % %     % %   %     %   %
% %%% % %%%%%%% %%%%% %%%%% %%%
%     % %         %   %   % % %
% %%%%% % %%%%%.% %%%%% % % % %
%     %         %       %     %
%%%%%%%%%%%%%%%%%%%%%%%%%%%%%%%
