%%%%%%%%%%%%%%%%%%%%%%%%%%%%%%%
%       %   %                 %
% % %%% % % % %%%%%%%%%%%%%%% %
% % %     % %     %         % %
% % %%%%%%% %%P%% %%%%% % %%% %
% %   %     %   % %     % %   %
%%%%% %%%%% % % % % %%%%% % % %
%   %     % % %   % %   % % % %
% % %%%%% %%% %%%%% % %%% % %%%
% %     %   % %     %     %   %
% %%%%% %%% % % %%%%%%%%%%%%% %
% %   %   % % %   %       %   %
% % % %%% % % % % % %%%%% % % %
%   % %   %   % %     %   % % %
%%%%% % %%% %%%%% %%%%% %%% % %
%   % % %       % %   % %   % %
% % % % % %%%%% % % % % % %%% %
% %   % % % % % % % %   %   % %
% %%%%% %%% % % %%% % %%%%% % %
% %   %     %       % %   % % %
% % % %%%%%%%%%%%%%%% % % % % %
% % %           %   % % %   % %
% % %%%%%%% %%% % %%% % %%%%% %
% %   %     % % % %   %     % %
% %%% % %%%%% % % % %%%%%%% % %
% %   %   %     %     %   % % %
% %%%%%%% % %%%%%%%%%%% % % % %
% %   %   % %         . %   % %
% % % % %%% % %%%%%%% % %%%%% %
%   %   %     %         %     %
%%%%%%%%%%%%%%%%%%%%%%%%%%%%%%%
