%%%%%%%%%%%%%%%%%%%%%%%%%%%%%%%
%     %       %         %     %
%%%%% % %%%%% % %%% %%% % % % %
%     %   %   % %   %   % % % %
% %%%%%%% % %%% % %%%%%%% % %%%
%   %     %     %         %   %
%%% % %%%%%%%%%%%%%%%%%%%%%%% %
%   % %     %   %     % %     %
% %%% % % % %%% % % % % % %%% %
%   % % % %   %   % %   % %   %
%%% % %%% %%% % %%% % %%% % %%%
%   %P%   % % % %   % %   %   %
% % % % %%% % %%% %%%%% %%%%%%%
% % % %   %   %   %   %   %   %
% %%% %%% % %%% %%% % %%% % % %
%   %   % %   % %   %   %   % %
%%% %%% % %%% % % %%%%% % %%% %
%     %   % %   % %     %   % %
% %%% %%%%% %%% % %%% %%%%%%% %
%   % %   %     %   % %       %
%%% % %%% % %%%%%%% % % %%%%%%%
%   %   % %       % %   %     %
% %%%%% % %%%%% %%% %%%%% %%% %
%   %     %     %   %     % % %
%%% % %%%%% %%%%% %%% %%%%% %%%
%   % %     %   %     .   %   %
% %%% % %%%%% % %%%%%%%%% % % %
%   % % %     %         %   % %
% % %%% %%%%%%%%%%% %%% %%%%% %
% %                 %         %
%%%%%%%%%%%%%%%%%%%%%%%%%%%%%%%
