%%%%%%%%%%%%%%%%%%%%%%%%%%%%%%%
%         %                   %
% % %%%%% % % %%% %%%%%%%%%%% %
% % % %   % % % % %         % %
%%% % % %%% %P% % % %%%%%%% %%%
%   %   %   % %   % %     %   %
% %%% %%%%%%% %%%%%%% % %%%%% %
%   % %     % %       %   %   %
% % % %%% % % % %%%%%%%%% % %%%
% % %     %   % %     %   %   %
%%% %%%%%%%%% % %%% %%% % %%% %
%   % %     % %     %   % %   %
% %%% % %%% % %%%%% % %%%%% %%%
%   %     %     %   %     % % %
%%% % %%%%%%%%% % %%%%%%% % % %
%   %   %   %   %   %     %   %
% %%%%%%% % %%%%%%% % %%.%%%% %
%     %   %     %   % %     % %
% %%% % %%%%%%% % %%% % %%% % %
% % % % %     %   % %   %   % %
% % % % % %%%%%%%%% %%%%% % % %
% % %   %           %     % % %
% % %%%%%%%%% %%%%% % %%%%%%% %
% %   %     %     % %         %
% % % % % % %%%%%%% %%%%%%%%%%%
%   % % % %         %         %
%%%%% % % %%%%%%%%% %%%%%%%%% %
% %   % %   %     % %   %     %
% % %%%%%%% % %%%%% % % % %%% %
%           %         %   %   %
%%%%%%%%%%%%%%%%%%%%%%%%%%%%%%%
