%%%%%%%%%%%%%%%%%%%%%%%%%%%%%%%
% %         %   %       %     %
% % %%%%% % % % %%% %%% % %%% %
% %   % % %   % %   % % %   % %
% %%% % % %%%%% % %%% % %%%%% %
%    P  % %   % %   %         %
% %%%%%%% %%% % % % %%%%%%%%% %
%     %   %   % % %     %   % %
%%%%%%% %%% %%% %%%%%%% % %%% %
%       %     % %     % %     %
% %%%%%%% %%% % % %%% % % %%%%%
% %       %   %   % %   % %   %
% %%%%% %%% %%%%%%% %%%%% %%% %
% %   % %   %   %       % %   %
% % % %%% %%% % % %%%%% % % %%%
% % %   %     % % %   %   %   %
% % %%% %%%%%%% % % % %%%%% % %
% % %   %       %   %   %   % %
% % % %%% %%%%% %%%%%%% %%%%% %
%   % % %   %     %   %       %
%%%%% % % % %%%%%%% % %%%%%%% %
%     %   %         % %     % %
% %%%%% %%%%%%%%%%%%% % %%% % %
%     %   % %  .    %   % %   %
%%%%% %%% % % % %%%%%%%%% %%%%%
%     %   %   %               %
% %%%%% %%%%%%% %%%%%%%%%%% % %
% %   % %     % %   %   %   % %
% % %%% % %%% %%% % % % % %%% %
% %       %       %   %   %   %
%%%%%%%%%%%%%%%%%%%%%%%%%%%%%%%
