%%%%%%%%%%%%%%%%%%%%%%%%%%%%%%%
%   %       %       %   %     %
% %%% %%% %%% % %%% % % %%% % %
%   %   % %   % %     %   % % %
% % %%% % % %%% %%%%%%%%% % %%%
% %   % % %   %     % %   %   %
% %%% % % %%% %%%%% % % %%%%% %
% % % % %     %   % %         %
% % % % %%%%%%P%% % %%%%%%%%% %
% % %           % %   %       %
% % %%%%%%%%%%% % %%% % %%%%%%%
%   %   %     %   %   % %     %
%%% % %%% %%% % %%% %%% % %%%%%
% % %   % %   % %   %   %     %
% % %%% % % %%%%% % %%%%%%%%% %
% %     % % %     % %     % % %
% % %%%%% % % % %%%%% % % % % %
%   %   % % % %   %   % %   % %
% %%% % % % % %%% % %%% %%% % %
%   % % % % %   %     % %   % %
% %%% % % % %%% %%%%% % % %%% %
% %   %   %   % %   % % %   % %
% % %%%%%%%%% %%% % % % %%%%% %
% %   %           % % %   %   %
% %%% %%%%% %%%%%%% %%%%% % %%%
%   %     % %   %         %   %
%%% %%%%% %%% % %%%%% %%%%%%% %
%   %   %     % %   % %     . %
% %%%%% %%%%%%% % % %%% %%%%%%%
%             %   %           %
%%%%%%%%%%%%%%%%%%%%%%%%%%%%%%%
