%%%%%%%%%%%%%%%%%%%%%%%%%%%%%%%
%       %   %   %             %
% %%%%% % % % % % %%%%%%% %%%%%
%   %   % %   % % % %   %     %
%%%%% % % %%%%% % % % % %%%%% %
%     % % %     %   % %     % %
% %%% %%%%% %%%%% %%% %%%%% % %
% %   %     %     %   %   % % %
% %%%%% %%%%% %%%%% %%% % % % %
%       %   %   %   % % % %   %
% %%%%%%% % % %%% %%% % % %%% %
%       % % % %   %   % %     %
%%%%%%% % %%% % %%%%% % %%%%%%%
%     % %     %   %   % % %   %
% %P% % %%%%%%%%% % %%% % % % %
% %   % %         %     %   % %
% % % % % %%%%%%%%% %%%%% %%% %
% % % %   %     %.  % %     % %
% % % %%%%%%% % % %%% % %%%%% %
% % %   %     % %   %   %     %
%%% %%% % %%%%%%%%% % %%% %%% %
%   %     %   %     % % %   % %
% %%% %%%%% % % %%%%% % %%% %%%
% %     %   % %     %     %   %
% %%%%%%% %%% %%%%% % %%%%%%% %
% %     %   %       % %       %
% % %%% %%% %%%%%%%%%%% %%%%% %
% % % %   % %     %     %   % %
% % % % %%% %%% % %%% %%% %%% %
%     %         %     %       %
%%%%%%%%%%%%%%%%%%%%%%%%%%%%%%%
