%%%%%%%%%%%%%%%%%%%%%%%%%%%%%%%
%     %         %     %       %
% % %%% %%% %%% % %%%%% %%% %%%
% % %     % % % %         %   %
% % % %%%%% % % % %%%%%%%%%%% %
% %   %     % % % %     %   % %
% %%%%% %%%%P % % % %%% % % % %
%     %   %   % % % % % % % % %
%%%%%%%%% %%% % %%% % % % % % %
%       % %   %   % %     %   %
% %%%%% % % %%%%% % % %%%%%%% %
% % %   % % %     % %   % %   %
% % % %%% % % %%%%% %%% % %%% %
% %       %         %   %   % %
% %%%%%%%%% %%%%%%%%% %%%%% % %
%   %   %   %   %     %   % % %
%%% % %%% %%% % % %%%%% % % % %
%   % %     % % %       % % % %
% %%% % %%%%% % %%%%%%%%% % % %
% %   %   %   %   %     % %.% %
% % %%% %%% %%%%% % %%% %%% % %
% %     %   %     % % % %   % %
% %%%%%%% %%% %%%%% % % % %%% %
%         % %     %   %   % % %
%%%%%%%%%%% %%%%% %%% %%%%% % %
%             % %   % %     % %
% %%% %%%%%%% % %%% % % %%%%% %
%   % %     %     %   %     % %
%%% % % %%% %%%%%%%%%%% %%% % %
%   %     %               %   %
%%%%%%%%%%%%%%%%%%%%%%%%%%%%%%%
