%%%%%%%%%%%%%%%%%%%%%%%%%%%%%%%
%     % %   %       %         %
% %%% % % % % %%% %%% %%%%% %%%
% % % %   %   %   %   %   %   %
% % % %%%%%%% % %%% %%% % %%% %
% % % %     % %     %   %     %
% % % % %%% % %%%%%%% %%%%%%% %
% % %     % %       %   %   % %
% % %%%%%%% % %%%%% %%% % %%% %
%   %       % %   %   % %   % %
%%% % %%%%P%%%% % % %%% % % % %
% % %           % % %   % %   %
% % %%%%%%%%%%%%% %%% %%% %%%%%
%   %       %     %   %     % %
% %%%%%%%%% % %%%%% %%%%%%% % %
%           % %           %   %
%%%%%%%%%%% % %%%%%%% %%% %%% %
%   %   %   % %     %   % %   %
% % % % % %%% % %%% %%%%% % %%%
% %   % % % % %   %   %   %   %
% %%%%%%% % % %%% %%% % %%%%% %
%         % %     %   %   %   %
% %%%%%%%%% %%%%%%% %%% %.%%%%%
% %           % %   %   %     %
% % %%%%%%%%% % % %%%%%%% %%% %
% %         % % % %     %   % %
% %%%%%%%%% % % %%% %%% %%%%% %
%   %   %   % %     % %       %
%%% % % % %%% %%%%% % %%%%%%% %
%     %   %         %         %
%%%%%%%%%%%%%%%%%%%%%%%%%%%%%%%
