%%%%%%%%%%%%%%%%%%%%%%%%%%%%%%%
% %       % %             %   %
% % % %%% % % %%%%% %%%%% % % %
% P %   % % %   %   %       % %
% %%%%% % % %%% % %%% %%%%%%%%%
%   %   %     % % %     %     %
%%% % %%%%%%%%% % %%%%%%% %%% %
% % %           %         % % %
% % %%%%%%%%%%%%%%%%%%%%%%% % %
% % %   %   %       %       % %
% % % % % % %%%%%%% % %%%%%%% %
%   % %   % %   %   % %       %
% %%% %%%%% % % % %%% % %%%%%%%
% %   %   % % % % %   %       %
% %%% % % % % % % % %%% %%%%% %
%   % % %   % % % . %   %     %
%%% % %%% %%% % % % %%%%% %%% %
%   %   %     %   %     %   % %
% %%% % %%%%% %%%%%%%%% %%% % %
% %   %     % %     %   %   % %
% %%%%%%%%% %%% %%% % %%% %%%%%
%   %   %   %     % %   %     %
%%% % % % %%% %%%%% %%% %%%%% %
% %   % % %   %       % %     %
% %%%%% % % %%% %%%%%%% % %%% %
%     % %   %   %       % % % %
% %%% % %%%%% %%% %%%%%%% % % %
%   % %       %   %       %   %
% % %%%%%%%%% % %%%%% %%%%% %%%
% %           %       %       %
%%%%%%%%%%%%%%%%%%%%%%%%%%%%%%%
