%%%%%%%%%%%%%%%%%%%%%%%%%%%%%%%
%     %  P    %       %       %
%%%%% % %%% % % % %%%%% % %%% %
%     %   % % % %       %   % %
% %%% %%% % %%% %%%%%%%%%%% %%%
% %     % % %   %         %   %
% %%%%%%% % % %%% % %%%%%%%%% %
%     %   % %   % % %       % %
% %%% % %%% %%% % %%% %%% %%% %
%   % % % %   % %     %   %   %
%%%%% % % %%% % %%% %%% % % %%%
%     % %   % %   % %   % %   %
% %%%%% % % % %%% %%% %%% %%% %
% %   %   % %     %   %     % %
% % % %%%%% %%%%%%% %%% %%%%% %
%   %     % %       % % % %   %
% %%%%%%% % %%% %%% % % % % %%%
% %       %   % %   %     %   %
% % %%%%%%%%% %%% . %%%%%%%%% %
% %         %   % % %       % %
% %%%%%%%%% %%% % %%% %%%%% % %
% %   %   %     %   % % %   % %
% % % %%% %%%%%%%%% % % % %%% %
%   %   %   %     % % % % %   %
%%%%%%% % % %%% % % %%% % % %%%
%     %   % %   % %     % % % %
% % %%%%%%% % %%% %%% %%% % % %
% %     %   % % %   %   %   % %
% %%%%% % %%% % %%% %%% %%%%% %
%     %       %               %
%%%%%%%%%%%%%%%%%%%%%%%%%%%%%%%
