%%%%%%%%%%%%%%%%%%%%%%%%%%%%%%%
%   %                 %   %   %
% % % %%% %%%%%%%%%%% % % %%% %
% % %   %   %   %     % %     %
%%% %%% %%% % % % %%%%% %%%%% %
%     %   %   % %     %     % %
% %%P%%%% %%%%% %%%%% % %%% % %
% %         %   %     % % % % %
% % %%%%%%%%% %%% %%%%% % % %%%
% % %         %   %   %   %   %
% % % %%%%%%%%%%% %%% %%% %%% %
%   % %         %   %       % %
% %%% % %%%%%%% %%% %%%%%%%%% %
% %   % %       %       %   % %
%%% %%% % %%%%%%%%%%%%% % % % %
%   %   %   %     %   %   %   %
% % % %%%%% % %%% % % %%%%%%%%%
% % %   % %     %   %         %
% % %%% % %%%%% %%%%%%%%%%%%% %
% %   %   %   %     %   %   % %
% %%%%% %%% % %%%%% % % % %%% %
%       %   %   % %   % % %   %
% %%%%%%% %%%%% % %%%%% % % % %
%     %   %   % %       %.% % %
%%%%% % %%% % %%% %%%%%%% % %%%
%   % % %   % %           %   %
% % % % %%% % %%%%%%%%%%% %%% %
% % % %   % % %   %     % %   %
% % % %%% % % % % % %%% %%% % %
% %     %   %   %   %       % %
%%%%%%%%%%%%%%%%%%%%%%%%%%%%%%%
