%%%%%%%%%%%%%%%%%%%%%%%%%%%%%%%
%             %               %
% %%% %%%%%%% % %%%%%%% %%%%% %
% % %   %   % % %       %     %
% % %%% % % %P% % %%%%%%% %%%%%
% %   %   %     % %   %   %   %
% %%% %%%%%%%%%%% %%% % %%% % %
%       %       %   %     % % %
%%%%%%% % %%% %%%%% %%%%% %%% %
% %     % % %     %     %     %
% % %%%%% % %%%%% %%% % %%%%%%%
%   %       %   % % % %       %
% %%%%%%%%% % % % % %%%%%%% % %
% %     %     % % % %     % % %
% % % % %%%%%%%%% % % %%% %%% %
% % % %           % %   %     %
% % % %%%%%%%%%%% % % % %%%%%%%
% % %   %       % % % %       %
% %%%%% % %%% %%% % %%% %%%%% %
%   %   %   %     %   % %     %
%%% % %%%%% %%%%%%%%% %.% %%%%%
% % % %     %       %     %   %
% % % % %%%%%%% %%% %%%%%%% % %
% %   % %       % % %       % %
% %%%%% % %%% %%% % % %%%%%%% %
%   %   %   % %   %   %   %   %
% % % %%%%%%% %%% %%%%% % % %%%
% %   %     %   %     % % % % %
% %%%%% %%% %%% % %%%%% % % % %
%       %       %       %     %
%%%%%%%%%%%%%%%%%%%%%%%%%%%%%%%
