%%%%%%%%%%%%%%%%%%%%%%%%%%%%%%%
%           P       %         %
%%%%%%% %%% %%% % %%% % %%%%% %
%       % %   % %     %   %   %
% %%%%%%% %%% %%%%% %%%%% %%% %
% %     %   % %   % %   %   % %
% % %%% %%% % % % %%% % % % % %
% % % %   %     %   % % % % % %
% % % %%% %%%%%%%%% % % %%% % %
%       %     %   % % %     % %
% %%%%%%%%%%% % % % % %%%%%%% %
% %           % % % %   %   % %
% % %%%%%%%%%%%%% % %%% % %%% %
% % %       %     %     %     %
% % % %%%%% % % %%%%%%%%% %%%%%
% % % %   %   % %       %   % %
% % %%% % %%%%% % %%% %%%%% % %
% % %   %     % % % %       % %
%%% % %%%%%%% % % % %%%%%%%%% %
%   %     % % % % %       %   %
% % %%%%% % %%% % %%. %%% % % %
% %     % %   % %   % %   % % %
% %%%%%%% % % % %%% % % %%%%% %
%   %   %   % %   %   % %     %
% % % % %%%%% % %%%%%%% % %%% %
% %   % %     %       % %   % %
% %%%%% % %%%%% %%% % % % % %%%
%   %   %   % % % % % % % %   %
%%% % %%%%% % % % % %%% %%%%% %
%   %       %     %           %
%%%%%%%%%%%%%%%%%%%%%%%%%%%%%%%
