%%%%%%%%%%%%%%%%%%%%%%%%%%%%%%%
%               % %           %
% %%% %%%%%%%%% % % % %%%%%%%%%
% % % %     %   %   %   %     %
% % % %%% %%% %%% %%%%% % %%% %
%   %   %     %   %   %   %   %
%%% %%% %%%%% % %%%%% %%%%% % %
% % % % % P % % %     % %   % %
% % % % % % % % % %%% % % %%% %
% % % %   % % % % % %   %   % %
% % % %%%%% % % % % %%% %%% % %
% %   %     % %   %   %   % % %
% %%% % %%%%% %%%%% % %%% % %%%
%   % %   % % %   % %   % %   %
% %%% %%% % % % % %%% % % %%% %
%     % % %   % %   % % %   % %
% %%%%% % %%% % %%% % % %%% % %
% %     %   %   % % % %     % %
% % % %%%%% %%%%% % %%% %%%%% %
% % % %   %   %   %   % %  .  %
% % %%% % %%% %%% %%% %%% %%% %
% %     %   %   %   %     %   %
% %%%%% %%% %%% % % % %%%%% %%%
% %   % %   %   % %   % % % % %
% % % %%% %%% %%%%%%%%% % % % %
% % %   %   %   %       % %   %
% % %%% %%% %%% % %%%%%%% %%% %
%   % % %   % % % %   %   %   %
%%%%% % % % % % % % %%% % % %%%
%         %   %   %     %     %
%%%%%%%%%%%%%%%%%%%%%%%%%%%%%%%
