%%%%%%%%%%%%%%%%%%%%%%%%%%%%%%%
%       %   %       %         %
% %%% %P% % % %%% % %%%%%%% % %
% %   %   %   % % %         % %
% % %%% %%%%%%% % %%%%%%%%%%% %
% %   %         % % %       % %
% %%% % %%%%%%%%% % % %%%%% % %
% %   % %     %   %       %   %
% % %%% % %%% % % %%%%%%% %%%%%
% %   % %   %   % %     %     %
%%%%% % %%% %%%%%%% %%% %%%%% %
%     %   %     %   %   %     %
% %%%%%%% %%%%% % %%% %%% %%%%%
%       % %     %   %   % %   %
% %%%%% % % %%% %%% %%% % % %%%
% %   %   % % % % % %   % %   %
% %%% %%%%% % % % % % %%% % % %
% %   %   % %     % % %   % % %
% % % %%% % % %%%%%%% % %%%%% %
% % %     % % % %     %  .  % %
% % %%%%% % % % % %%%%%%%%% % %
% %   % % % %   % % %   %   % %
% %%% % % % %%%%% % % % % %%% %
%     %   % %     % % % %   % %
%%% %%%%%%% % %%%%% % % %%% % %
% % %       % %       %   % % %
% % % %%%%%%% % %%%%%%% %%% % %
% % %   %   % % %   %   %   % %
% % %%% % % % % % % % %%% %%% %
%     %   %   %   % %         %
%%%%%%%%%%%%%%%%%%%%%%%%%%%%%%%
