%%%%%%%%%%%%%%%%%%%%%%%%%%%%%%%
%             %     % %       %
% %%% %%%%%%% % % % % % %%% %%%
% %   %   % % % % %   % % %   %
% % %%% % % % %%% % %%% % %%% %
% %     % % %   % % %     %   %
% %%%%%%% % %%% % %%% %%%%% % %
%   %     %   % % %   %     % %
%%% % %%%%% %%% % % %%% %%%%% %
%   % %     %   %     %   %   %
% %%% % %%%%% %%% %%%%%%% % %%%
% % % % %     %   %     % % % %
% % % % % %%%%%%%%% %%% % % % %
% % % %   %     %   %   % %   %
% % % % %P%%% % % %%% %%% %%% %
% % % %       % %   % %     % %
% % % % %%%%%%% %%% % %%%%% %%%
%   % % %     %     %     %   %
% %%% %%% %%% %%%%%%%%%%% %%% %
% %   %   % % %         %   % %
%%% %%% %%% % %%% % %%%%%%% % %
%   %   %   %   % % %     % % %
% %%% %%%%% %%%%% %%% % % % % %
%     %     %   %     % % %   %
%%%%%%% % % %%% % %%%%% %%%%% %
% %   % % %     % %   . %   % %
% % % % % %%%%%%% % %%% % % % %
% % % % % %       %   % % %   %
% % % % % % %%%%%%%%% % % %%%%%
%   %   %             %       %
%%%%%%%%%%%%%%%%%%%%%%%%%%%%%%%
