%%%%%%%%%%%%%%%%%%%%%%%%%%%%%%%
%   %           %         %   %
% % %%%%%%%%% %%% %%%%% % % % %
% %         %     %   % %   % %
% %P%%%%%%% %%%%% % % % %%%%%%%
% %             %   % % %     %
% % %%%%%%%%%%% %%%%% % % %%% %
% %   %     % %     % % %   % %
% %%%%% %%% % %%%%% %%% % %%% %
% %     % % %     %   %   %   %
% % %%%%% % % %%% %%% %%%%% % %
%   %     % % %   %   %     % %
%%%%% %%% % % %%%%% %%% %%%%% %
% %   % % % %     % %       % %
% % % % % % % %%% % % %%%%% %%%
% % % %   % % %   % %     %   %
% % % %%%%%%%%% % % %%%%% %%% %
%   % %       % % %     % %   %
% %%% % % %%% % %%%%%%% %%% %%%
%   %   % %     %     %   %   %
%%% %%%%% %%%%%.% %%% %%% %%% %
% % %   %   %       %   %   % %
% % % % %%% % %%%%%%% % %%% % %
% %   % %   %   % %   %   %   %
% %%% %%% % %%% % % %%%%%%%%% %
%     %   % %   % % %       % %
%%%%%%% %%%%% %%% % % %%% %%% %
%       %   % %   %   % %   % %
% %%%%%%% % % % % %%%%% %%% % %
%         %     %         %   %
%%%%%%%%%%%%%%%%%%%%%%%%%%%%%%%
