%%%%%%%%%%%%%%%%%%%%%%%%%%%%%%%
%       %             %   %   %
% %%%%% %%% %%%%%%%%% % %%% % %
%   %       %     %   %     % %
% % %%%%%%%%% % % % %%%%%%%%% %
% %     %   % % % %         % %
%%%%% % % %%% % %%%%%%%%%%% % %
%   % % % %   %           %   %
% % %%% % % %%%%%%%%% %%%%%%% %
% %     %           % %       %
% % %%%%%%%%%%%%%%%%% % %%%%%%%
% % %   %   P %     % %   %   %
% %%% % % %%% % %%% % %%% %%% %
%   % % % %     % %     %   % %
%%% % % % %%%%%%% %%% %%%%% % %
%   % % %   %   %     %   % % %
% %%% % %%% % % %%% %%% % % % %
%     %   %   %   %   % % %   %
%%%%%%%%% %%%%%%% %%%%% % %%% %
%       % %     %       %     %
% %%%%% % % %%% %%%%%%%%%%%%% %
%   %     % % %   %   %     % %
% % % %%%%% % %.% % % % %%% %%%
% % % %     %   %   %   %   % %
% % % % %%%%% %%%%%%%%%%% %%% %
% % % % %   %     %       %   %
% % % % % % % % %%% %%%%%%% %%%
% % % % % % % %   %   %     % %
% % %%% % % %%%%% %%% % %%%%% %
% %       %         %         %
%%%%%%%%%%%%%%%%%%%%%%%%%%%%%%%
