%%%%%%%%%%%%%%%%%%%%%%%%%%%%%%%
%       %         %           %
% % %%%%% %%% % %%% %%% %%%%% %
% %     %   % % %     % %   % %
%%%%%%% %%% % %%% %%%%% % % % %
%     % %   %P    %     % % % %
% %%% % % %%%%%%%%% %%%%% %%% %
%   % %   %     %   %   % %   %
%%% % % %%% %%% % %%% % % % %%%
%   % %   % %   % %   %   % % %
% %%% % %%% % %%% %%% %%% % % %
% % % % %   %   % %   %   % % %
% % % % % %%%%% % % %%% %%% % %
%   % % % %     % % %     % % %
%%% % %%% %%%%% % % %%%%%%% % %
%   %   %     %   .   %     % %
% %%%%% % %%% %%%%% % % %%%%% %
% % %   % %   %   % % %       %
% % % %%% % %%% %%% % %%%%%%% %
% % % % % % %   %   %       % %
% % % % % % %%% % %%%%% % %%% %
% % % %   %   %   %   % % %   %
% % %%%%%%%%% % %%% % % %%% %%%
%   %         % %   % %     % %
%%% % % %%%%%%% % % %%%%%%%%% %
% % % % %   %   % %           %
% % %%% %%% % %%%%%%% % %%%%% %
% %     %   %   %   % % %   % %
% %%%%%%% %%%%% % % %%% % %%% %
%                 %     %     %
%%%%%%%%%%%%%%%%%%%%%%%%%%%%%%%
