%%%%%%%%%%%%%%%%%%%%%%%%%%%%%%%
%   %       %               % %
%%% % %%% % %%%%%%%%%%% %%% % %
%   %   % % %   %       % % % %
% %%% %%% % % % % % %%%%% % % %
%     %   %   %   % %   %   % %
% %%%%% %%%%%%%%%%%%% % %%% % %
%   % % %           % %   %   %
%%% % % % %%%%% %%% % %%% %%% %
%     % % %   % % %   % %   % %
%%%%%%% % % % % % %%%%% %%% %%%
%     % % % %   % %       %   %
% %%% % % %%%%%%% % %%% % %%% %
% %     % P       % %   %   % %
% %%%%%%%%%%%%%%%%% % %%%%%%% %
%               %   % %   %   %
% %%%%%%% %%%%%%% %%% % % % %%%
%       % %     %   %   %   % %
%%%%%%% % % %%% %%% %%%%%%%%% %
% %   % % % % %   %   %       %
% % % % % % % % %%%%% % %%%%% %
% % %   %   % % %   %   %.  % %
% % %%%%%%%%% % % % %%%%% % % %
% %       %   %   %       %   %
% %%%%%%% %%% %%%%%%%%%%%%%%%%%
%       %       %   %   %     %
% %%%%% %%%%%%% % % % % %%%%% %
%     %     %   % %   %       %
%%%%% %%% %%% %%% %%%%%%%%%%% %
%       %         %           %
%%%%%%%%%%%%%%%%%%%%%%%%%%%%%%%
