%%%%%%%%%%%%%%%%%%%%%%%%%%%%%%%
%             %   %           %
%%%%% %%%%%%% %%% % %%% %%%%% %
%     %   %     %     %   %   %
% %%% % % %%%%% %%%%%%%%% % %%%
% % % % %     %     %     %   %
% % % %P%%%%% %%%%% % %%%%%%% %
% %   %   %   %   %   %     % %
% %%%%%%%%% %%% % %%%%% %%% % %
% %     %   %   %       %   % %
% % %%% % %%% % %%%%%%%%%%%%% %
% % % % % % % % %             %
% % % % % % % % % %%%%%%%%%%%%%
%   % %   %   %   %     %     %
%%%%% %%%%% %%%%%%% %%% % %%%%%
%         % %       % % %     %
%%%%%%% % % %%% % %%% %.%%%%% %
%     % % %   % % % %   %     %
% %%% % % %%% %%% % % %%% %%%%%
% % %   % %   %   % % %       %
% % %%%%% % %%% %%% % %%%%%%% %
% % %     % %     % %       % %
% % % %%%%% %%%%% % %%%%%%% % %
% %   %   %       %   %     % %
% %%%%% % %%%%%%%%% % % %%%%% %
%   %   %   %   %   % % % %   %
% % % %%%%% % % % % %%% % % % %
% %   %     % %   %   % %   % %
% %%%%% %%%%% %%%%%%% % %%%%% %
%     %             %         %
%%%%%%%%%%%%%%%%%%%%%%%%%%%%%%%
