%%%%%%%%%%%%%%%%%%%%%%%%%%%%%%%
%                     %       %
% %%%%%%%%%%%%%%%%% % % %%% %%%
% %             % % % %   %   %
% % %%%%% %%%%% % % % %%% %%% %
% % %   % %   % % % % %   %   %
% %%% % % % % % % % %%% %%% %%%
%   % % % % % %   %   %   %   %
%%% % % % % %%%%% %%% %%% %%% %
% % % %   % %   %   %     % % %
% % %P%%%%% % % % %%%%%%% % % %
%   %   %     %   % %   %   % %
% %%% % %%% %%%%%%% % % %%%%% %
% %   %   %   % %   % %       %
% %%%%%%% %%% % % %%% %%%%%%%%%
% %       % % % % %   %       %
% % %%%%%%% % % % % %%% % %%%%%
% %       %   % % %   % %     %
% %%% %%% %%% % % % % % %%%%% %
%   %   %   %   % % % %     % %
%%% %%% %%% %%% % %%% %%%%% % %
% % % %   % %   %   % % % . % %
% % % %%% % %%%%%%% % % % %%% %
% % %     %       %   % %   % %
% % %%%%%%%%%%%%% %%%%% %%% % %
%   %       %   %     %     % %
% %%% %%%%% % % % % % %%%%%%% %
%   % %   % % % % % %   %   % %
%%% % % % % % % %%% %%% % % % %
%     % %     %     %     %   %
%%%%%%%%%%%%%%%%%%%%%%%%%%%%%%%
