%%%%%%%%%%%%%%%%%%%%%%%%%%%%%%%
%       %     %     %     %   %
% %%%%% % %%% % % %%% % % % % %
% %       %   % % %   % % % % %
% %%%%%%%%% %%% % % %%% % % %%%
%       %   %   % % % % % %   %
% %%%%% % %%%%P%% % % % % %%% %
% %     %         % % % %     %
%%% %%% %%%%%%%%% % % % %%%%% %
%   %   %   %   % %   %   %   %
% %%%%%%% % % % %%%%% %%% % %%%
%         %   % %     %   % % %
% %%%%%%%%%%%%% % %%%%% % %%% %
%   % %     %   % %   % % %   %
%%% % % %%% % %%% % % % % % %%%
%   %     % %   %   % % % %   %
% %%%%%%%%% %%% %%%%% % %%%%% %
%   %     %   %   %   %     % %
%%% % %%% %%% % %%% %%%%% %%% %
% %   % %   % %   %   % %     %
% %%%%% %%% % %%% %%% % %%%%%%%
%           % %     %     %   %
%%%%%%%%% %%% % %%%%%%%%% %%% %
%       %     % %       % %   %
% %%%%% %%%%%%% %.%%%%% % % %%%
%   %   %       % %   %   %   %
% % % %%% %%%%% % % % %%%%%%% %
% % %     %   % % % %     %   %
% % %%%%%%% % %%% %%%%% % % % %
% %         %           %   % %
%%%%%%%%%%%%%%%%%%%%%%%%%%%%%%%
