%%%%%%%%%%%%%%%%%%%%%%%%%%%%%%%
%     %       %     %     %   %
% % %%% %P%%% % %%% % %%%%% % %
% % %   % %   %   %   %     % %
% %%% %%% % %%%%% %%%%% %%%%% %
%   % %   %       %   %   %   %
% % % % %%%%%%%%% % % %%%%% %%%
% %   % %       % % %   %   % %
% %%%%% % %%%%% %%% % % % %%% %
% %   %   %   %     % % %     %
% %%% %%%%% %%%%%%%%% %%%%%%% %
%   %       %       %       % %
%%% % %%%%%%% % %%% %%%%%%% % %
%   %         % %   %     %   %
% %%% %%%%%%%%% %%%%% % % %%%%%
%   %   %     % %     % %     %
%%% %%%%% %%% % % %%%%% %%%%% %
% %     %   %   %   % % % %   %
% %%%%% % % %%%%%%% % % % % %%%
% %     % %           % %   % %
% % %%%%%%%%%%%%%%% %%% % %%% %
% % %       %     % %   %   % %
% % % % %%% % %%% %%. %%%%% % %
%   % % %     % %     %   %   %
% %%% % %%%%%%% %%%%%%% % %%% %
%   % %     %         % % %   %
%%% % %%%%% %%% %%%%%%% % % %%%
% % % %   %   %   %   % %   % %
% % %%% % %%% % % % % % %%%%% %
%       %     % %   %         %
%%%%%%%%%%%%%%%%%%%%%%%%%%%%%%%
