%%%%%%%%%%%%%%%%%%%%%%%%%%%%%%%
%       %P  %       %         %
% %%%%% % % % %%%%% % % %%%%%%%
% %   % % %   %   %   %       %
% % % %%% %%%%% %%%%%%%%% %%% %
%   %       %       %   % %   %
%%%%%%%%%%% %%%%% %%% % % % %%%
%       % %       %   % % %   %
% %%%%% % %%%%% %%% %%% %%% % %
% %     %     % %   % %   % % %
% % %%%%%%%%% % % %%% %%% % % %
% %         %   % % %   % % % %
% %%%%%%%%% %%% % % % % % % % %
%       % %   % % % % %   % % %
% %%%%% % %%% % % % % %%%%%%% %
% % %   %   % % % %   %     % %
% % % %%% % % %%% % %%% %%% % %
%   % %   %       % %  .% %   %
%%% % %%%%%%%%%%%%% %%% % %%% %
% % %         %   %   % %     %
% % %%%%%%%%% %%% %%% % %%%%%%%
%       %     %   % % % %     %
%%%%%%%%% %%%%% % % % % % %%% %
%         %     %   % %     % %
% %%%%%%%%% %%%%%%%%% %%%%%%% %
%     % %           %     %   %
% %%% % % %%%%%%%%% %%%%% % %%%
% %   % %     %   %       %   %
% % %%% %%%%% % % %%%%%%%%%%% %
% % %           %             %
%%%%%%%%%%%%%%%%%%%%%%%%%%%%%%%
