%%%%%%%%%%%%%%%%%%%%%%%%%%%%%%%
%     %             %     %   %
% %%P % %%%%% %%%%% %%%%% % % %
%   % % %   % %   %   %   % % %
% % %%% % % % % % %%% % % % %%%
% % %   % %   % %   %   % %   %
% % % %%% %%% % %%% %%%%%%%%% %
% % % % %   % %   %     %     %
% % % % %%% %%%%% %%%%% % %%%%%
% % % %   %       %   % % %   %
% % % % %%%%%%%%%%% % % % %%% %
% % % %       %     % % %   % %
%%% % %%%%%%% % %%%%% % %%% % %
%   %       %       % %   %   %
% % %%%%%%% %%%%%%%%% % % %%% %
% % %     % %       % % %   % %
% % % %%%%% % %%%%% % % %%% % %
% % % %   % % % %     %   % % %
% % % % % % % % % %%%%%%% %%% %
% %   % %   % %   % %   %   % %
% %%%%% %%%%% %%% % % % %%% % %
%     % %       %   % %   % % %
% %%% % %%%%%%% % %%% %%% % % %
% %   % %       % %   %     % %
% % %%% % %%%%%%%%% %%%%%%%%% %
% %   % %         %   %     % %
% %%% % % %%%%%%% %%% % %%% % %
%   %   %       %   %   % .   %
%%% %%%%%%%%%%%%% % %%%%% %%%%%
%                 %           %
%%%%%%%%%%%%%%%%%%%%%%%%%%%%%%%
