%%%%%%%%%%%%%%%%%%%%%%%%%%%%%%%
%         %     %           % %
% %%%%% %%% % % %%%%%%%%% % % %
% %     %  P% %         % %   %
% %%%%%%% %%% %%%%%%%%% % %%% %
% %         %       %     % % %
% % %%%%%%% %%%%%%% %%%%%%% % %
%   %     %     % % %   %     %
% %%% %%% %%%%% % % % % %%%%%%%
% %   %   %   % % %   %       %
% % %%% %%% %%% % %%%%%%%%%%% %
% % %   %       %       %     %
%%% % %%%%%%% %%%%%%% % % %%% %
%   % %     %       % % %   % %
% %%%%% %%% %%%%%%% %%% %%% %%%
%   %     % %             %   %
%%% %%%%% % %%%%%%%%%%%%%%%%% %
% %     % %           %     % %
% %%%%% % %%%%%%%%%%% % %%% % %
%     %   %         %   % %   %
% % %%%%%%%%%%% %%%%%%%%% %%% %
% %           % .           % %
% %%%%%%% %%% % % %%%%% % %%% %
% %     % % %   %   %   % %   %
% % %%% % % % %%% %%% %%% % %%%
% %   % % %   %   %   %   %   %
% %%%%% % %%%%% %%% %%%%%%%%% %
%       % %     % % %   %     %
%%%%%%% % % %%%%% % % % % %%%%%
%       %         %   %       %
%%%%%%%%%%%%%%%%%%%%%%%%%%%%%%%
