%%%%%%%%%%%%%%%%%%%%%%%%%%%%%%%
%   %   %     %               %
% % % % % %%%%%%%%% % %%%%%%%%%
% %   % % %       % %         %
% %%%%% % %%% %%% %%% %%%%%%% %
% %   P % %   % %   %       % %
% % %%%%% % %%% %%% %%%%%%% % %
% %     %   %     % %     % % %
% %%%%%%%%%%% %%% % % %%% %%% %
% %         %   % % % % %   % %
% % %%% %%% %%%%% % % % %%% % %
%   % %   %     % % % %   %   %
% %%% %%% %%%%% % % % % % %%% %
%     %   %   %   % % % % %   %
%%%%%%% % % % %%% % % % % % %%%
%       % % % %   %   % %   % %
% %%%%% %%% % %%%%%%%%% %%%%% %
% %   % %   %         % % .   %
% % % %%% %%%%%%%%%%% % %%% % %
% % %   %   %       %   %   % %
% % %%% %%% %%%%%%% %%%%% %%% %
% %   %   % %           %   % %
% % %%%%% % % %%%%%%%%% % % %%%
%   %     % %     % %   % %   %
%%%%% %%%%% %%%%% % % %%%%%%% %
%     %   %       % % %     % %
% %%%%% % %%%%%%%%% % %%% % % %
%     % %   %       % %   %   %
% %%% % % %%% %%%%% % % %%%%% %
%   %   %         %     %     %
%%%%%%%%%%%%%%%%%%%%%%%%%%%%%%%
