%%%%%%%%%%%%%%%%%%%%%%%%%%%%%%%
%   %                         %
% % %%%%%%%%%%P %%%%%%%%%%%%% %
% %             %   %       % %
% %%% %%%%%%%%%%% %%% %%%%% % %
%   % %       %   %   %   %   %
% % %%% %%%%% % %%% %%% % %%%%%
% %     %   % %   %   % %     %
% %%%%%%% % % % % %%% %%%%% % %
% %       % % % %         % % %
% %%% %%%%% % %%%%%%%%%%% % % %
% %   %   % %   %   %   % % % %
% % %%% %%% %%% % % % % % %%% %
%   %         %   % % % % %   %
%%% %%%%%%%%% %%%%% %%% % % %%%
%   %     %       %   % % %   %
%%%%% %%% %%%%%%% %%% % % % % %
%     %   %     %   % %.  % % %
% %%%%% %%% %%% %%% % % %%% % %
% %   %   % % %   % % %   % % %
% %%% %%% % % %%% % % %%% %%% %
%   %   %   % %   % % %   %   %
% % % % %%%%% % %%% % %%% % % %
% % % %   %   % % % %   %   % %
% % %%% %%% % % % % %%% %%%%% %
% %   %     % % %     % % %   %
% %%% %%%%%%% % %%% %%% % % %%%
% %   %   %   %   % %   % %   %
% % %%% % % %%%%% %%% %%% %%% %
% %     % %           %       %
%%%%%%%%%%%%%%%%%%%%%%%%%%%%%%%
