%%%%%%%%%%%%%%%%%%%%%%%%%%%%%%%
%     %         %         %   %
% %%% % %%%%% % %%%%% %%%%% % %
% % %   %     %       %   % % %
% % %%%%% %%%%%%%%% %%% % % % %
%   %   % %   %     %   %   % %
%%%%% % % % % %%%%%%% %%%%%%% %
%     %   % %     %   %     % %
% %%% %%%%% %%%%% % %%%%%%% % %
%   % %   %     % %     %   % %
% % %%%P% %%%%% % %%%%% % % % %
% %     % %     %       % % % %
% %%%%%%% % %%%%%%% %%%%% %%% %
%     %   %   %   %       %   %
% %%%%% %%%%% % % %%%%%%%%% % %
% %     %     % %     %     % %
% % %%%%% %%%%% %%%%% % %%%%% %
% %   %       % %   % % %     %
%%%%% % %%%%%%% % % % % %%%%%%%
%   %   %     % % %   % %     %
% % %%% % %%% % %%% %%% % %%% %
% %   % %   % %   %   % % % % %
% %%% % %%% % %%% %%% % % % % %
%   % %   % % %   %   %     % %
%%% % %%%%% % % %%% %%%%%%% % %
%   %       %   % % %     % % %
% %%%%%%%%%%%%%%% % % %%% %%% %
%               %  .  % %     %
% %%%%%%%%%%%%% %%%%%%% %%%%% %
%             %     %         %
%%%%%%%%%%%%%%%%%%%%%%%%%%%%%%%
