%%%%%%%%%%%%%%%%%%%%%%%%%%%%%%%
%                       %     %
%%%%%%%%%%% %%%%% %%%%%%% %%% %
%   %     %     %           % %
% % %%%%% %%%%% %%%%%%%%%%%%% %
% %   %   %   % %   %     %   %
% % %%% %%% % % % % % %%% % % %
% %   % % % %     % % % %   % %
% %%% % % % %%%%%%%%% % %%%%% %
% % %   %   % %   %   %   %   %
% % %%%%% %%% % % % %%% % % %%%
%     %       % %   %   %   % %
%%%%% %P%%%%% % %%%%% %%%%%%% %
%   %   %   % %   % %   %     %
%%% %%% % % % %%% % %%% % %%% %
%   %   % %   %   %   %   %   %
% %%% %%% %%%%% %%% % %%%%% %%%
%     %   %   %   % %     % % %
% %%%%% %%% % % % %%% %%% % % %
%   % % % % % % %   %   %.%   %
%%% % % % % % %%%%% %%% %%%%% %
% % %   % % %     %   %       %
% % % %%% % %%%%% % % % %%%%%%%
% % %     %   %   % % %       %
% % %%%%%%%%% % %%%%% %%%%%%% %
% %           %       %       %
% %%%%%%%%%%%%%%%%%%%%% %%%%%%%
%         %     %   %   %     %
% %%%%%%% % % %%% % % %%% %%% %
%       %   %     %       %   %
%%%%%%%%%%%%%%%%%%%%%%%%%%%%%%%
