%%%%%%%%%%%%%%%%%%%%%%%%%%%%%%%
%                     %       %
% %%%%%%%%%%%%%%%%%%% %%%%% %%%
% %       %   %     %     %   %
% % % %%%%% % % %%% %%%%% %%% %
% % %       % P   %           %
% %%%%% %%%%% %%% %%%%%%%%%%% %
%     %     %     % %       % %
% %%% % %%%%%%% %%% % %%%%% % %
% %   % %     %     %   %   % %
% % %%% % %%% %%%%% %%% % %%%%%
% % %   % % %     % %   %     %
%%% % %%% % %%%%% %%% %%% %%% %
%   % % %     %   %   % %   % %
% %%% % %%%%% % % % %%% % %%% %
% %     %     % % % % % % %   %
% %%%%%%% %%%%% %%% % % % % %%%
% %     %     %     % % % %   %
% % %%% %%%%% %%%%%%% % % %%% %
% % % %     %   %     % %   % %
% % % % %%%%%%% % % %%% %%% % %
% %   %         % %   %   % % %
% %%% %%%%%%%%%%%%%%% %%% %.% %
% %   %   %             %     %
% % %%% % %%% %%%%%%%%% %%%%%%%
%   %   %     %       %       %
% %%%%% %%%%%%%%%%% %%%%%%%%% %
%       %   %       %     %   %
%%%%%%%%% %%% % %%%%% %%% % %%%
%             %         %     %
%%%%%%%%%%%%%%%%%%%%%%%%%%%%%%%
