%%%%%%%%%%%%%%%%%%%%%%%%%%%%%%%
%       %     %   %       %   %
% %%%%% % %%% % %%% % %%% %%% %
%   % %   % % %     %   %   % %
%%% % %%%%% % %%%%%%%%% %%% % %
%   %       %       %   %   % %
% %%% %%%%% %%%%%%% % %%% %%% %
%   % %   %         % %       %
%%% % % %%% %%%%%%%%% %%%%%%%%%
%   % % % %     % %           %
% %%%%% % %%%%% % % %%%%%%%%% %
%     % %   %   %   %   %   % %
%%P%% % % % % %%% %%% % % % % %
%   %   % % % % %     %   % % %
% %%%%%%% % % % %%%%%%% %%%%% %
% %       % % % %       %     %
% % % %%%%% % % % %%%%%%% %%% %
%   %   %   % %     %     % % %
% %%%%% %%% % %%%%%%% %%%%% % %
% %   %   % %   %     %     % %
% %%% %%% % %%% % %%%%% %%% % %
%   % %   %   % %   % %   %   %
%%% % % %%%%% % % % % %%% %%%%%
%   % % %     % % % % %   %   %
% %%% % %%%%% % %%% % % %%% % %
% %   % %   % %     % %     % %
% %%% % % % %%%%%%%%% %%%%%%% %
%   % %   %     %     . %     %
%%% % %%%%%%% %%% %%%%% % %%%%%
%           %         %       %
%%%%%%%%%%%%%%%%%%%%%%%%%%%%%%%
