%%%%%%%%%%%%%%%%%%%%%%%%%%%%%%%
%       %               %     %
% % %%%%% %%%%%%% %%%%% %%% % %
% %     % %     %     %   % % %
% %%%%% % % %%% %%%%% %%% %%% %
% %   %   % % % %   %   %     %
% %P% %%%%% % % % % %%% %%%%% %
%   % %     %   % %   %     % %
%%%%% % %%%%% %%% %%% %%%%% % %
%   % %     % %   % % %     % %
%%% % % %%% % % % % % % %%%%% %
%   % %   % % % % %   %   %   %
% %%% %%%%% % %%% %%%%%%% % %%%
%         % %     %       %   %
% %%%%%%% % % %%%%% %%%%%%%%% %
%   %   %   % %     %         %
%%% % %%%%%%% % %%%%%%%%%.%%%%%
%   %   %     %               %
% %%%%% %%%%%%% %%%%%%%%%%%%% %
%     %       %           %   %
%%%%% %%%%%%% %%% %%%%%%% % %%%
%     %   %   %   %   %   %   %
% %%%%% % % %%% %%% % %%% %%% %
%     % % %   % %   %   %   % %
%%%%% %%% %%% %%% %%%%% % %%% %
%   %   %   %   % %   % % %   %
% % %%% %%% %%% % %%% % %%% % %
% %   % %   % % % %   %   % % %
% %%%%% % % % % % % %%%%% % % %
%         %   %   %         % %
%%%%%%%%%%%%%%%%%%%%%%%%%%%%%%%
