%%%%%%%%%%%%%%%%%%%%%%%%%%%%%%%
%         %   %       %   %   %
%%%%% %%%%% % % % %%%%% %%% %%%
%   % %     %   %       %     %
% % % % %%%%%%%%%%%%%%%%% %%% %
% %   % %     %       %   % % %
% %%%%% % %%% % %%% % % %%% % %
% %     % %   % % % % % %   % %
% % %%%%% % %%% % % %%% % %%% %
% %   %   % %     % %     %   %
% %%P % %%%%% %%%%% % %%%%% % %
% %   %       %   %   %   % % %
% % %%% %%%%%%% % %%%%% % % % %
%   %   %       %       %   % %
% %%% %%% %%%%%%% %%%%%%%%%%% %
% %     %       % %     % %   %
% % %%%%%%%%%%% %%% %%% % % %%%
% % %   %       %     % %   % %
% %%% % % %%%%%%% %%%%% % %%% %
%   % %   %       % %   %     %
%%% % %%%%% %%%%%%% % %%% %%%%%
% % %       %       %   % %   %
% % %%%%%%% %%%%%%% %%% % % % %
% %       %      .  %   % % % %
% %%%%%%% %%%%%%%%% % %%%%% % %
%       %     %     %       % %
%%%%% %%%%%%% % %%%%%%%%%%%%% %
%     %   %   %     %       % %
% %%%%% % % %%%%%%%%% %%%%% % %
%       %             %       %
%%%%%%%%%%%%%%%%%%%%%%%%%%%%%%%
