%%%%%%%%%%%%%%%%%%%%%%%%%%%%%%%
%         %                   %
% %%%%%%% %%% %%%%%%%%%%%%%%%%%
% %   %     %   %             %
% % % %%%%% %%% % %%%%%%%%%%% %
% % %     %   %   %       %   %
% % %%%%% %%% % %%%%% % % % %%%
%   %     %   %     % % % %   %
% %%% %%%%% %%%%%%% %%% %%%%% %
% %   %     %       %   %   % %
% % %%% %%%%%%%%% %%% %%% % % %
% % % %   %     %     %   %   %
% % % %P% %%% % % %%%%% %%%%%%%
% % %   %     % % %   %       %
%%% % %%%%%%%%% %%% % % %%%%% %
%   %         %   % % %   %   %
% % %%%%%%%%% %%% % % . %%% % %
% % %       %   %   % % %   % %
% %%% %%%%% % % %%%%% %%% %%% %
% %   %   % % % %   %     % % %
% % %%% % % % % % % %%%%%%% % %
% %     % % % % % %     %   % %
% %%%%%%%%% % % % %%% % % % % %
%     %     % %     % % % %   %
%%% % % %%%%%%%%%%%%% % % %%%%%
%   % % %         %   % % %   %
% %%%%% % %%%%%%% % %%%%% % % %
% %   %   %     % %     %   % %
% % % %%%%% % %%% % %%% %%%%% %
%   %       %     %   %       %
%%%%%%%%%%%%%%%%%%%%%%%%%%%%%%%
