%%%%%%%%%%%%%%%%%%%%%%%%%%%%%%%
%   %       %                 %
%%% % %%% %%% % %%%%% %%%%%%%%%
%   % % %     %     % %       %
% %%% % %%%%%%%%%%% %%% %%%%% %
%     % P   %     %   % %   % %
% %%%%%%% %%% % % %%% % % % % %
%       %     % %   %   % % % %
%%%%%%% %%%%%%% %%%%% %%% % % %
%   %           %   % %   %   %
% %%% %%%%%%%%% % % %%% %%%%%%%
% %   % % %   % % %   % %   % %
% % %%% % % % %%% %%% % % % % %
%   %   %   %   % % %   % % % %
% %%% %%%%%%%%% % % %%%%% % % %
%   %         %   % %     %   %
%%% % % %%%%% %%%%% % % %%%%% %
% % % % %   %     %   % %   % %
% % %%% % % %%%%% % %%% % %%% %
% %     % %     % % %   % %   %
% %%%%%%% %%%%% % %%% %%% % %%%
%           %   %     %   %   %
% %%%%% %%%%% %%%%%%%%%%% %%% %
% %   % %   % %   %       %   %
% % % %%% % % % % % % %%%%% %%%
% % %     %   % % % %       % %
% % %%%%%%% %%% % % %%%%%%%%% %
% % %       %   % % %         %
% % %%%%%%%%% %%% . %%%%%%% % %
% %             %           % %
%%%%%%%%%%%%%%%%%%%%%%%%%%%%%%%
