%%%%%%%%%%%%%%%%%%%%%%%%%%%%%%%
%   %             %     %     %
% %%% % %%%%%%%%% %%%%% % %%% %
% %   %         %     %   % % %
% % %%%%%%%%%%% %%%%% %%% % % %
% %     %   %   %   %   %   % %
% %%%%% %%% % %%%%% %%% %%%%% %
%     %   % %     %   % %     %
% % %%%%% % %%%%% % %%% % %%% %
% %             % %       % % %
% %%%%%%%%%%%%%%% % %%%%%%% % %
% %     %   %   % % %   %   % %
%P% %%% % % % %%% %%% % %%% % %
% % % %   %   % %     %   %   %
% % % %%%%%%%%% % %%%%%%% %%% %
% % %       % %         %   % %
% % % %%%%% % % %%%%%%%%% % % %
% % %   % % % % %       % % % %
% % %%% % % % % % %%%%% % % % %
% %   % %   % % %   %   % % . %
%%%%% % % %%% % %%% % %%%%% % %
%   %   % % %   %   %       % %
% % %%%%% % % %%% %%%%%%%%%%% %
% % %     % % % %     %     % %
% % % %%%%% % % %%%%% % % %%% %
% %   %     % %     % % %   % %
% %%%%%%% % % %%% %%% % %%% % %
% %     % %       %   %   %   %
% %%% % %%%%%%%%%%% %%%%% %%%%%
%     %             %         %
%%%%%%%%%%%%%%%%%%%%%%%%%%%%%%%
