%%%%%%%%%%%%%%%%%%%%%%%%%%%%%%%
% %       P         %   %     %
% % %%% % %%% %%% % % %%% %%% %
%   %   %   %   % %   %   % % %
% %%% %%%%% %%%%% % %%% %%% % %
% %   %       %   % %   %   % %
% % %%%%%%%%% % %%% % %%% % % %
% %     %   %   %   % %   % % %
% %%%%% % % % %%%%%%% %%%%% % %
% %   %   % % %       %   %   %
% % % %%%%% % % %%%%%%% % % %%%
% % %       % %   %     % % % %
%%% %%%%%%%%% %%% % %%%%% % % %
%   %       %   %   %     % % %
% %%% %%%%%%%%% %%%%% %%%%% % %
% %           % %   %     % % %
% % %%%%%%%%% % % % %%%%% % % %
% % %     % %   % %   %   %   %
% % % %%% % %%%%% %%% % %%%%% %
% %   % %   %   % % %   %     %
% %%%%% %%% % %%%%% %%%%% %%%%%
%     %   %   %     %     %   %
% %%% %%% % %%% % % % %%%%% %%%
%   %   % % %   % % % %   %   %
% %%%%% % % % %%% %.% % % % % %
% %   % %   %   %     % %   % %
% % % % %%%%%%% %%%%%%% %%%%% %
% % %   %       %       %   % %
% % %%%%% %%%%%%%%%%%%%%% % % %
% %                       %   %
%%%%%%%%%%%%%%%%%%%%%%%%%%%%%%%
