%%%%%%%%%%%%%%%%%%%%%%%%%%%%%%%
%       %   %               % %
%%% %%% % % % %%% %%%%%%%%% % %
%   %   % %     %   %     %   %
% %%% %%%%%%%%%%% % % %%% %%% %
% %       %     % % %   % % % %
% %%%%%%% % %%% % % %%% % % % %
%   %   %   %   % %   % % %   %
% % % %%%%%%% %%% %%% % % %%%%%
% % %     %   %   % %   % %   %
%%% % % % % %%%%% % %%%%% % % %
%   % % % %     % %     %   % %
% %%% % %%%%%%% % % % %%%%%%% %
%   % %   %   % %   % %       %
%%% % %%% P % % %%%%%%% %%%%% %
%   % % %   % % %     %   %   %
% %%% % %%%%% % % %%% %%% %%%%%
% %   % %   % % %   %   %     %
% %%% % % % % % %%% %%% %%%%% %
%   %   % %   %     %   %     %
%%% %%% % %%%%%%%%%%% %%% %%%%%
%   %   %           %   %     %
% %%%%%%% %%% %%%%% %%% %%%%% %
%     % %   %     %   % %     %
%%%%% % %%%%% %%% %%.%% % %%% %
%   % %     % %   %   % % %   %
% % % %%%%% % % % % % % % %%% %
% %   %     % % % % % % %   % %
% %%%%% %%%%% % %%% % % %%% % %
%       %     %     %       % %
%%%%%%%%%%%%%%%%%%%%%%%%%%%%%%%
