%%%%%%%%%%%%%%%%%%%%%%%%%%%%%%%
% %     %               %     %
% % %%% % %%% %%%%%%%%% % %%% %
%   % %   P % %   %       %   %
% %%% %%%%% % % % %%% %%%%%%% %
%   %       % % %   % %     % %
%%% %%%%%%% % % %%% %%% %%% % %
%           %     %       % % %
% %%%%%%%%% %%%%% %%%%%%%%% % %
% %       % %   % %         % %
%%% %%%%% %%% % %%% %%%%%%%%% %
%   % %       %     %   %     %
% %%% % %%%%%%%%%%%%% % %%%%%%%
% %     %             % %     %
% %%%%%%% %%%%%%%%%%%%% % %%% %
% %     % %   % %     %   % % %
% % %%% % % %%% % % %%.%%%% % %
% % % % % % %   % %     %     %
% % % % % % % %%% %%%%% % %%%%%
% % % % %   %     %     % %   %
% % % % %%%%% %%%%% %%%%% % % %
%   % %   %   %   % %     % % %
% %%% %%% % %%% % % % %%%%% %%%
%   % %   %   % % % % %       %
%%% % % % %%% % %%% % %%%%%%% %
%   % % %   % % %   %       % %
% %%% % %%%%% % % %%%%%%%%% % %
%     % %   % % %         % % %
%%%%% % % % % % %%% %%%%%%% % %
%     %   %       %           %
%%%%%%%%%%%%%%%%%%%%%%%%%%%%%%%
