%%%%%%%%%%%%%%%%%%%%%%%%%%%%%%%
%   %       %               % %
% %%% %%% % %%%%%%%%%%% % % % %
% %     % %           % % %   %
% % %%%%% %%%%%%%%%%% %%% %%% %
%   %   % %         %   % %   %
% %%% % % %%%%%%% %%%%% % %%%%%
%   % %   %     %     % %     %
%%%%% %%% % %%% % %%% % %%%%% %
%     %   % %   %   %     %   %
% %%%%% %%% % %%%%%%%%%%% % % %
% %     %  P%   %     %     % %
% %%%%%%% %%%%% % %%% %%%%%%% %
%     %   %   %     %   %   % %
% %%% % %%%%% %%%%%%%%% % % % %
% % %         %         %.% % %
% % %%%%% %%%%% %%%%%%%%% % % %
%   %   % %     %     %   %   %
% %%% % %%% %%%%%%% % % %%%%%%%
% %   %   %   %   % % %       %
%%% %%%%% %%% % % %%% %%%%%%% %
%   %         % %   %     %   %
% %%% %%%%%%%%% %%% %%% %%% %%%
%   % %     %   % %   %     % %
%%% %%% %%% % %%% %%% %%%%% % %
% %     % %   %     %     % % %
% %%%%%%% %%%%% %%% %%%%%%% % %
% %           % %       %   % %
% % %%% %%%%%%% % %%%%%%% %%% %
%     %         %             %
%%%%%%%%%%%%%%%%%%%%%%%%%%%%%%%
