%%%%%%%%%%%%%%%%%%%%%%%%%%%%%%%
% %   %                 %     %
% % % % % %%%%%%%%%%%%% % %%% %
% % %   %     %   %   % %   % %
% % %%%%% %%% %%% % % % %%% % %
%   %   % %   %   % %   %   % %
% %%% % %%% %%% % % %%%%% %%% %
%   % % %   %   % %       % % %
% %%% % % %%% %%%%%%%%%%%%% % %
% %   % %   %P          %     %
%%% %%% % % % %%%%%%%%% % %%%%%
%   %   % % %     %   %   %   %
% %%% %%% % %%%%%%% % % %%%%% %
% % %   % % %       % % %     %
% % %%% %%% % %%%%%%% % %%% % %
% % % % %   %     % % %     % %
% % % % % % %%%%% % % %%%%%%% %
% % %     % %     %   % %     %
% % %%%%%%% % %%%%% %%% % %%%%%
% %   %     % %     % %   %   %
% %%% %%%%%%% % %%%%% % %%%%% %
%   %         % %     %       %
% %%%%%%%%%%%%% % %%% %%%%%%% %
% %         %   %   %       % %
% % %%%%% % % %%%%% %%%%%%. % %
% %   %   % %     %       % % %
% %%% % %%%%%%%%% %%%%%%% %%% %
%     %         %       %   % %
% %%%%%%%%%%%%% %%%%%%% % % % %
%             %         % %   %
%%%%%%%%%%%%%%%%%%%%%%%%%%%%%%%
