%%%%%%%%%%%%%%%%%%%%%%%%%%%%%%%
% %     %   %           %     %
% % %%% % % % % %%%%%%% % %%%%%
% % % %   %   %       % %     %
% % % %%%%%%%%%%%%%%% % %%% % %
% %     %           % %   % % %
% %%%%% %%% %%% %%% % %%% %%% %
%     %   % %   % % % %       %
%%% % %%% %%% %%% % % %%%%%%%%%
%   %   %   %   % % %   %     %
% %%%%%%%%% % % % % %%% % %%% %
%         %P% % %     %   %   %
% %%%%%%% % %%% %%%%% %%%%% % %
%   %     %   %     %     % % %
%%% % %%%%%%% %%%%% % %%%%% % %
%   % %       %     % %     % %
% %%% % %%%%%%% %%%%% % %%%%% %
% % %           %     %   %   %
% % %%%%%%%%%%%%% %%%%%%% %%%%%
%   %     %       %     %   % %
%%% % %%% %%%%%%%%% %%% %%% % %
%   %   %         %   %     % %
%%%%%%% %%%%%%%%% %%% %%%.% % %
%       %   %         %     % %
% % %%%%% % %%%%%%%%%%%%%%% % %
% % %     % %   %         % % %
% % % %%%%% % % % %%%%%%% % % %
% % %     % % %   %     % % % %
% %%%%%%% % % %%%%%%%%% % %%% %
%         %             %     %
%%%%%%%%%%%%%%%%%%%%%%%%%%%%%%%
