%%%%%%%%%%%%%%%%%%%%%%%%%%%%%%%
%       %         %         % %
%%%%% % %P% % %%%%% %%%%% % % %
%   % %   % % %   % %   % %   %
% % %%%%%%% % % % % % %%% %%% %
% %         % % %   %   %   % %
% %%%%%%%%%%% % %%%%%%% % % %%%
% %         % % %     % % %   %
% % %%%%%%% %%% % % %%% % %%% %
% %   %   %     % %   % % % % %
% %%% %%% %%%%%%% %%% % % % % %
%   %   %     %   % % % %   % %
% % %%% % % %%% %%% % % %%%%% %
% %   % % %         % %       %
% %%% % % %%%%%%%%%%% %%%%%%%%%
%   %   %   %         %       %
%%% %%%%%%%%% %%%%%%% % %%%%% %
%   %         %     %   %   % %
% %%% %%%%%%%%% %%%%%%%%%%% % %
% %     %       %     %     % %
% %%%%% % %%% %%% % % % %%% % %
% %     % %   %   % % % %   % %
% % %%%%% %%%%% %%% % % %%.%% %
% % %           % % %   %     %
% % % %%%%%%%%%%% % %%%%% %%%%%
%   % % %       % %       %   %
%%%%% % % % %%% % %%%%%%%%%%% %
% %   %   % %   %             %
% % %%%%%%% % %%%%%%%%% %%%%% %
%           %           %     %
%%%%%%%%%%%%%%%%%%%%%%%%%%%%%%%
