%%%%%%%%%%%%%%%%%%%%%%%%%%%%%%%
%             % %     %       %
% %%%%%%% % % % % %%% % %%%%% %
%   %   % % % % %   %   % %   %
%%% % % %%% % % %%% %%%%% % %%%
%   % %   % % %   %       %   %
% %%% %%% % % % %%%%%%%%% %%% %
%   % %     %P%     %     %   %
%%% % %%%%%%% %%% %%% %%%%% % %
%   %       %   %     %     % %
%%%%%%%%%%% %%% % %%%%% %%%%% %
%           %   %     % %     %
% %%%%%%%%%%% %%%%%%%%% % %%%%%
% %     %     %     %   % %   %
% % %%% % %%%%% % % % %%% %%% %
% %   % %   %   % %   % %   % %
% %%%%% %%% %%%%% %%%%% %%% % %
% % %     % %   % %       %   %
% % % %%% % % % % % %%% % %%% %
%   %   % % % % . % % % %   % %
%%%%% % %%% % %%%%% % % %%%%% %
%   % %   % %   % %   %     % %
% %%% %%% % %%% % %%% %%%%% % %
% %   % % % %   %     %     % %
% % %%% % % % %%%%%%%%% %%%%% %
% % %   %   %       %   %     %
% % % % %%%%% %%%%% % %%% %%%%%
% %   % %         % %   %     %
% %%%%% %%%%%%%%%%% % % %%%%% %
%                   % %       %
%%%%%%%%%%%%%%%%%%%%%%%%%%%%%%%
