%%%%%%%%%%%%%%%%%%%%%%%%%%%%%%%
%     %           %       %   %
% %%% % % %%%%%%% %%% %%% % % %
%   % % %       %     % %   % %
% % %%% %%%%%%% %%%%%%% %%%%% %
% %         %   % %       %   %
% %%%%%%%%%%% %%% % % %%% % %%%
%   %         %   % %   % % % %
%%%%% P%%%%%%%% % % %%% %%% % %
%   % %       % %     % %   % %
% % % %%%%% % % %%%%%%% % %%% %
% %   %   % %   %       % %   %
% %%%%% % %%% %%% % %%%%% % % %
%     % %   %   % % %     % % %
% %%% % %%% %%% % %%% %%%%%%% %
% %   % % % %   % %   .     % %
% % %%% % % %%%%% % %%% % % % %
% %       %     %   %   % % % %
% %%%%%%%%%%%%% % %%% %%% % % %
%   %   %       %   %   % %   %
% %%% % % %%%%%%%%% %%% % %%%%%
% %   % % %       % %   %     %
% % %%%%% %%%%%%% % %%%%%%%%% %
% %     % %       %     %   % %
% %%%%% % % %%%%% %%%%% % % % %
% % %   % %   %       %   %   %
% % % %%% % % % %%%%%%%%%%%%% %
%   %   % % % %   %     %   % %
%%% %%% % % % %%%%% % %%% % % %
%     %   % %       %     %   %
%%%%%%%%%%%%%%%%%%%%%%%%%%%%%%%
