%%%%%%%%%%%%%%%%%%%%%%%%%%%%%%%
%       %   %     %       %   %
% % %%%%% % % %%% % % %%% %%% %
% %       % % % % % %   %     %
% %%%%%%%%% % % % % %%% %%%%% %
% %         %   % % %   %   % %
% % %%%%%%%%%%%%% % % %%%%% % %
% %     %       % % %     %   %
% %%%%% %%%%% % % % %%%%% % %%%
% %   %   %   %   % %   % % % %
% %%% %%%P% %%% %%% % % % % % %
% %   %   %   % %   % % % %   %
% % %%%%%%% % % % %%% %%% %%% %
% % %   %   % % % %     %   % %
% % % % % %%% %%% %%%%% %%% % %
% %   %     %             % % %
% %%%%%%% %%%%%%% %%%%%%%%% % %
%       % %     % %       % % %
%%%%%%% % % %%% %%% %%%%% % % %
% %   % % % %       %   % % % %
% % % % % % %%%%%%%%% %%% % % %
% % %   % %     %   %       % %
% % %%%%%%%%% % % % % %%%%%%%%%
% %         % %   % %   %     %
% %%%%%%%%% %%% %%% %%%%% %%% %
% %   %   %   % %   %     %   %
% % % % % %%% % % %%% %%%%% % %
%   %   %     % %     %     % %
% %%%%%%%%%%%%%%.%%%%%% %%%%% %
%                       %     %
%%%%%%%%%%%%%%%%%%%%%%%%%%%%%%%
