%%%%%%%%%%%%%%%%%%%%%%%%%%%%%%%
%     %     %           %     %
% %%% % %%% % % %%%%%%% %%% % %
% %     % % % %   %   %   % % %
% %%%%%%% % % %%% % % %%% % %%%
%   %       % % %   % % % %   %
%%% % %%%%%%% % %%%%% % % %%% %
%   % %   %   % %     %       %
% %%%%% % % %%% % %%%%% %%%%% %
% %     %   %   % %     %   % %
% % %%%%%P%%% % % %%%%%%% % % %
% % %   %     % % %       % % %
% % % % %%%%%%%%% % %%%%%%% % %
%   % %         % % %   %   % %
%%%%% %%%%%%%%% % % % % % %%% %
%   % %   %     % %   % %   % %
% % % %%% % %%%%% % %%%%% % % %
% %   %   %   % %   %   % % % %
% %%%%% %%%%% % % %%% % % % % %
% %   %     % % %   % % % % % %
% % % %%%%% %%% %%% % % %%% %%%
%   % %     %       % %   %   %
%%%%% % %%% %%%%%%%%% %%% %%% %
%   % %   %         %   % %   %
% %%% % % %%%%%%%%% % % % % % %
%     % % %       % % % %   % %
% %%%%%%% % %%%%%%% %%%.%%%%% %
%   %     % %       %   %     %
%%% % %%%%% % %%%%%%% %%% %%%%%
%     %               %       %
%%%%%%%%%%%%%%%%%%%%%%%%%%%%%%%
