%%%%%%%%%%%%%%%%%%%%%%%%%%%%%%%
%   %   %       % %       %   %
% % % % % %%% % % % % %%% % %%%
% % % %   % % %   % % % % %   %
% %%% %%%%% % %%%%% % % % %%% %
% %   %     %       % %       %
% % %%% %%%%%%P%%%%%% %%%%%%% %
% %   % %           %   %     %
% %%% % % %%%%%%%%% % % % %%%%%
% %     %       %   % % % %   %
% % %%%%%%%%%%% %%% %%% % %%% %
%   %         %   %     %     %
% %%% %%%%%%% %%% %%%%%%%%%%% %
% %   %     %   %         %   %
% % %%% %%% %%% %%%%% %%% %%%%%
% % %   %     % %   %   %     %
%%% % %%% %%%%% % % %%% %%%%% %
%   %   %         %   %   %   %
% %%%%% %%%%%%%%%%%%% %%%%% %%%
%     %     %   %   %     %   %
% %%% %%%%%%%%% %%% %%%%% % % %
%   %   %     % %   %   % % % %
%%%%%%% % % %%% % % %%% % %%% %
%       % %     % % %   %   % %
% %%%%%%% %%%%%%% % % %%%%% % %
%   %     %       %   %   %   %
%%% % %%%%% %%%%%%.%%%% % %%% %
% %   %   %   %         %     %
% %%%%% %%% % % %%%%%%%%%%%%%%%
%           %                 %
%%%%%%%%%%%%%%%%%%%%%%%%%%%%%%%
