%%%%%%%%%%%%%%%%%%%%%%%%%%%%%%%
% %   %     %                 %
% P % % %%% % %%%%%%%%% %%%%% %
% % % %   %   %       %     % %
% % % %%% %%%%% %%%%% %%%%% % %
% % %     %   %   %   %     % %
% % %%%%%%% % % %%% %%% %%%%% %
% % %   %   % % %   %   %   % %
% % % %%% % %%% % % % %%% % % %
% % %     %     % % %     % % %
% % %%%%%%%%%%%%% % %%%%%%% % %
%   %             % %   % % % %
% %%% %%%%%%%%%%%%% % %%% % %%%
%   %   %         % %   % %   %
%%% %%% % %%%%%%% % %%% % %%% %
% % %   %       % %   % % %   %
% % % %%% %%%%% %%%%% % % % %%%
%   % % % %   %     %   %   % %
% %%% % % % % %%% % %%% %%%%% %
% %   %   % %     % %   %     %
% % %%% %%% % %%%%% % %%%%%%% %
% % %   % % % %   % %     %   %
% % %%% % % %%% % %%%%%%% % %%%
% %   %   %     %   %   % %   %
% %%% %%% %%%%%%%%% % % % % % %
%     %   %       %   %   % % %
%%%%%%% %%%%% %%% %%%%%%%%%%% %
% %   % %     %   %   .       %
% % % % %%% %%% %%%%%%%%% %%% %
%   %       %             %   %
%%%%%%%%%%%%%%%%%%%%%%%%%%%%%%%
