%%%%%%%%%%%%%%%%%%%%%%%%%%%%%%%
%       %   %     %     %     %
% %%% % % % % % %%% %%% % %%% %
% %   %   % % %   % %   %   % %
% % %%%%%%% % %%% % % %%%%% % %
%P% % %     % %   % %     % % %
%%% % % %%%%% % % % %%% % % % %
%   % % %   % % % %   % % % % %
% %%% % % %%% % %%%%% % %%% % %
%   %   %     %       % %   % %
%%% % %%%%%%%%%%%%%%%%% % %%% %
%   %                 % % %   %
% %%%%%%%%%%%%%%%%%%% % % % %%%
% %     %               % % % %
% %%% % % %%%%%%%%%%%%%%% % % %
%   % % %       %     %   %   %
% % %%% %%%%%%% % % %%% %%%%% %
% % %     %     % % %   %   % %
% % % %%% % %%%%% % % %%%%% . %
% % %   % % %     % %   %   % %
% % % % % % % %%%%% %%% % %%% %
% % % % % % % %   % %   % %   %
% % % % %%% % %%% %%% %%% % %%%
% % % % %       %   % %   % % %
% % % % % %%%%%%%%% % % % % % %
% % % %     %     % % % % %   %
% % %%%%%%% % %%% % % % % %%% %
% %   %   % % % % %   % %   % %
% %%% % % %%% % % %%%%% % %%% %
%   %   %       %       %     %
%%%%%%%%%%%%%%%%%%%%%%%%%%%%%%%
