%%%%%%%%%%%%%%%%%%%%%%%%%%%%%%%
%   %     %       %           %
% %%% % %%% % %%% % %%%%% %%% %
%     %     %   % %   %   % % %
%%%%%%%%%%%%%%% % %%% % %%% % %
%         %     % %   % %   % %
% %%%%%%% % %%%%% % %%% % % % %
% %   % %   % %   % % % % % % %
% % % % %%%%% % %%% % % % % % %
%   % %     P   %     % % %   %
% %%% %%%%% %%%%%%%%%%% % %%%%%
% %   %   %       %     %     %
% % %%% % %%%%%%% % %%%%%%%%% %
% %     %     %   % % %       %
% %%%%%%%%%%% % %%% % % %%%%%%%
%     %     % %     % % %     %
%%%%% % % % % %%%%%%% % % % %%%
% %   % % % % % %     % % %   %
% % %%%%% %%% % % %%%.% %%%%% %
% % %     %   %   % % %     % %
% % % % % % %%%%% % % %%%%% % %
% % % % % %     %   % %     % %
% % %%% % %%%%% % %%% % %%%%% %
%       % %     % %   % %     %
% %%%%%%%%% %%%%% % %%% %%%%% %
%   %       %     %     %   % %
%%% % %%%%%%% %%%%%%%%%%% % % %
% % %   %   % %         % % % %
% %%%%% % % % %%%%% %%% % % % %
%       % %         %     %   %
%%%%%%%%%%%%%%%%%%%%%%%%%%%%%%%
