%%%%%%%%%%%%%%%%%%%%%%%%%%%%%%%
% %    P    %     %       %   %
% % %%%%% % % %%% %%%%% % % % %
% % % %   % % % %     % % % % %
% % % % %%% % % %%%%% % %%% % %
%     %   %   %     % %     % %
% %%%%%%% %%%%%%%%% % % %%%%% %
% %     % %       % % % % %   %
% % %%% % % %%%%% % % % % % %%%
% %   %   %     % % % %   %   %
%%%%% %%%%% %%% % % % %%%%% % %
%     %     %   %   %     % % %
% %%%%% %%%%% %%% %%%%%%% % % %
%   %   %   % %   %   %   % % %
%%% % %%%%% % %%%%% % % %%%%% %
%   % %   % %   %   %   %     %
% %%% % % % %%% % %%%%%%% %%% %
% % %   %   % % %   % %     % %
% % %%%%%%% % % %%% % % %%% %%%
% %     %   % %     %     %   %
% % % %%% %%% %%%%%%%%%%%%%%% %
% % % %   %       %     %   % %
% %%% % %%%%%%% % %%% % % % % %
%   % %     %   %     % % %   %
%%% % %%%%% % %%%%%%%%% % %%% %
%   %       % %       %.  % % %
% %%% %%%%%%% % %%% %%%%%%% % %
%   %   %     % % %     %   % %
%%% %%% %%%%% % % %%%%% % % % %
%   %         %       %   %   %
%%%%%%%%%%%%%%%%%%%%%%%%%%%%%%%
