%%%%%%%%%%%%%%%%%%%%%%%%%%%%%%%
%     %           %   %       %
% % %%% %%%%% %%%%% % % %%%%% %
% %     % %   %     % %   % % %
% %%%%%%% P %%% %%%%% %%% % % %
% %       % %   %   %   %   % %
% % % %%%%% % %%%%% %%% % %%% %
% % % %   % % %       %   %   %
% %%% % % % % % %%%%%%%%%%% % %
%     % % %     %     %     % %
%%%%%%% % %%%%% % %%% % %%%%% %
%       %     % % % % % %     %
% % %%%%%%%%% %%% % % % % %%%%%
% % %     %   %   %   % %     %
% % % %%% % %%% %%% %%% %%%%%%%
% % % %   %     % % %         %
% %%% % %%%%%%%%% % %%%%%%%%% %
%   % %     %     %           %
% % % %%%%% % %%% %%%%%%%%%%% %
% %   % %   % %   %   %     % %
% %%%%% % %%% % %%%%% % %%% % %
% %     % %   %       % %   % %
% %%% % % % %%%%%%%%%%% % %%% %
%     % % %             %     %
%%%%% %%% % %%%%% %%%%%%%%%%%%%
%   % %   % %   % %     %     %
% %%% % %%%%% % %.% %%% %%%%% %
%   % %   %   % %   % %     % %
% % % %%% %%%%% %%%%% %%%%% % %
% %     %       %             %
%%%%%%%%%%%%%%%%%%%%%%%%%%%%%%%
