%%%%%%%%%%%%%%%%%%%%%%%%%%%%%%%
%   %         %       %   %   %
% %%% %%% %%% % %%%%% %%% % % %
% %   %   % %   %   %   %   % %
% % %%% %%% %%%%% %%%%% %%%%% %
%   %   %       %     % %   % %
%%%%% %%% %%%%% %%% %%% % % % %
%     %   %   %     %   % %   %
% %%%%% % % % % %%%%% %%% %%% %
% %     %   % % %   % %   % % %
% % %%% %%%%% %%% % % % %%% % %
% % % %   %   %   % %   %   % %
% % % %%% % %%% %%% %%%%%%% % %
% % %P%   %     %   %       % %
% % % %%%%% %%%%% %%% % %%% % %
% % %     % %   %     % %   % %
% % %%%%% % % % %%%%%%% %%%%% %
% %   %   %   %   %   %       %
% %%%%% %%%%%%%%% %%% %%%%%%%%%
%   %   %   %         %       %
% % % %%% % %%%%%%%%% % %%%%%%%
% % %     %       % % %   .   %
% % %%%%%%%%%%%%% % % % % % % %
% %         %     % % % % % % %
%%%%%%%%% % % %%%%% % % % % % %
%         % %   %   % % %   % %
% %%%%%%%%%%%%% % %%% % %%%%% %
%       %       %     %   %   %
% %%%%% % %%%%%%% %%%%%%%%% % %
%     %   %                 % %
%%%%%%%%%%%%%%%%%%%%%%%%%%%%%%%
