%%%%%%%%%%%%%%%%%%%%%%%%%%%%%%%
%     %   %   %       %       %
% %%% % % % %%%%% %%% %%% % % %
% %   % %   %     % %   % % % %
% %%%%% %%%%% % %%% %%% % % %%%
%   %   %   % %   %   % % %   %
% % % %%% % % %%% %%% % % %%% %
% %   %   %   % %   %   %   % %
% %%%%% %P%%%%% %%% % %%%%%%% %
%   %   %       %   % %       %
%%% % %%% %%%%% % %%% % %%%%% %
%   % %   %     % % % %   %   %
% %%% % %%%%% %%% % % % % % %%%
% % %   %   %   % %   % % % % %
% % % %%% % %%%%% % %%% % % % %
% %   %   %       %   % % % % %
% %%%%% %%%%%%%%%%%%% %%% % % %
%       %           % %   %   %
%%%%%%%%% %%% %%%%%%% % %.%%% %
%         %   %       % %     %
% % %%%%%%% %%% %%%%%%% %%%%% %
% % %     % %   %     % %   % %
%%% %%%%% % % %%%%% % % % % %%%
%   %   % % %       % % % %   %
% %%% % % % %%%%%%%%% % % %%% %
%     % %   %     %   %     % %
% %%%%% %%% % % % % %%%%%%% % %
% %   %   % % % % % %   %   % %
% % % %%% %%% % %%% % % %%%%% %
%   %   %     %       %       %
%%%%%%%%%%%%%%%%%%%%%%%%%%%%%%%
