%%%%%%%%%%%%%%%%%%%%%%%%%%%%%%%
%                 %   %       %
% %%%%%%%%%%%%%%% % % % %%%%% %
%   P %       % %   %   %     %
% %%% % %%%%% % % %%%%%%% %%%%%
%   %   % %   % % %     %     %
%%% %%%%% % %%% % % %%% %%%%% %
%   %     %   %   %   %     % %
% %%% % %%%%% %%%%%%% %%%%% % %
% %   %   %   %         %   % %
% %%%%%%% % %%% %%%%%%%%% %%%%%
%   %     %       %     %     %
%%% % %%%%%%%%%%%%% %%% %%% % %
%   %   %           % %   % % %
% %%%%% % %%%%%%%%%%% %%% % % %
%       % %   %         % % % %
%%%%%%% % % % %%% % %%% % %%% %
%       %   %   % % %   %     %
%%%%%%%%%%%%%%% % % % %%%%%%% %
%     %         % % % %       %
% %%% % %%%%%%%%% % %%% %%%%%%%
%   %   %         %   % %     %
%%% %%%%%%%%%%%%%.%%% % %%% % %
%   %           %   % %   % % %
% %%% %%%%%%%%% % % % %%% %%% %
%   % %         % %     %   % %
%%% % % %%%%% %%% %%%%%%%%% % %
%   % % %   % % % %   %     % %
% %%% % % % %%% % % % % %%%%% %
%     %   %     %   %         %
%%%%%%%%%%%%%%%%%%%%%%%%%%%%%%%
