%%%%%%%%%%%%%%%%%%%%%%%%%%%%%%%
%         %   %           %   %
%%% %%%%% % % % %%%%% %%% % % %
%   %     % %   %     %     % %
% %%% %%%%%%%%%%% %%%%%%%%%%% %
% %         %   %         % % %
% %%%%%%%%% % % %%% %%%%% % % %
%         %   %   %     % %   %
% %%%%%%% %%%%%%% %%%%% % % %%%
%   %   %     %   %     % % % %
%%% % % %%%%% %%% %%% %%% % % %
%   % %     %   %   % %   % % %
% %%% %%% %%%%% %%% % % %%% % %
%   %   %     % % % % %   %   %
%%% %%%%%%%P% % % % %%%%% %%% %
% % %     %   % % %       % % %
% % % %%% % %%% % %%%%%%%%% % %
%   % % % % %   %     %       %
% %%% % % % % %%%%%%% % %%%%%%%
% %   %     % %     % % %     %
% %%% %%%%%%% % %%% % %%% %%% %
% %   %       % %   %   % % % %
% % % % % %%%%% % %%%%% % % % %
%   % % % %     %     %   % % %
%%%%% % % % %%%%%%%%% %%%%% % %
%     % % % %     % %       % %
% %%%%% %%% % %%. % %%%%% % % %
%     %   % %   %   %   % % % %
%%%%% %%% % %%% %%% %%% % %%% %
%       %       %       %     %
%%%%%%%%%%%%%%%%%%%%%%%%%%%%%%%
